네, 언제부터 언제까지 묵으세요?	4월 셋째 주 금토일로 2박 3일로 부탁드립니다
파티룸 있나요?	파티룸 있어요
취사도구도 갖추어져 있나요?	취사도구는 다 준비되어 있어요
초크 좀 새로 준비해주세요	새 초크는 당구대 아래쪽에 준비되어 있습니다
다음 주 토요일에 6인 가능한 방 있나요?	있어요
당구장까지 오는 짜장면 집 있나요?	카운터에서 전화해서 시켜드릴게요
정액권 종류가 어떻게 돼요?	10시간 20시간이 있습니다
예약도 가능한가요?	약은 어렵습니다
몇 시에 준비해드릴까요?	저녁 7시요
화장실에 기저귀 교환대가 있을까요?	기저귀 교환대는 아직 없는 상태에요
시간당 얼마예요?	천 원입니다
체크인은 몇 시부터 하나요?	체크인은 3시부터이고 체크아웃은 11시까지예요
그러면 청소년들은 몇 시까지 이용이 가능해요?	청소년들은 아침 9시부터 저녁 10시까지 이용 가능하세요
룸서비스는 이용 시간이 몇 시부터 몇 시까지예요?	룸서비스 조식은 일곱시부터 여덟시까지 이용이 가능하시고, 중식과 석식은 오전 열시에서 밤 아홉시까지 가능하세요
출력할 때는 말씀드리고 뽑아야 하나요?	아뇨 뽑고 말씀해주셔도 돼요
그럼 새우탕 하나 끓여주세요	단무지 추가 천 원입니다
네 서비스 음료 뭐로 드릴까요?	알겠습니다
무엇을 도와 드릴까요?	가족 네 명이 오월 오일에 묵으려고 하는데, 바다 뷰가 보이는 곳이 얼마 정도 할까요?
계산은 카드로도 가능한가요?	카드로도 계산 가능하세요
바비큐 장비는 있나요?	그릴과 숯불 등 편하게 사용하실 수 있게 장비가 전부 준비되어 있어 고기만 준비하시면 됩니다
95년생 맞으세요?	95년생 맞습니다
자리 있나요?	현재 포켓볼 자리만 있어요
투숙객이 호텔 내에서 공짜로 이용할 수 있는 곳은 어디인가요?	수영장 헬스장 사우나이지만 다른 분들은 이용요금을 지불해야해요
이용하실 날짜가 언제쯤인가요?	토요일이요
회원가랑 비회원가랑 혹시 다른가요?	회원가랑 비회원가랑 다릅니다
회원가입해야 이용 가능한가요?	게스트로도 이용 가능하세요
열 시간 선불할게요	만 원입니다
컴퓨터 사양은 요즘 유행하는 게임이 다 돌아가나요?	배틀그라운드 돌아갑니다
거기 3일 연박도 돼요?	3일 연박 가능해요
예약했는데 확인 좀 해주실래요?	객실은 2006호실 오션뷰에요
얼마나 기다려야 하죠?	10분 정도 예상되네요
흡연부스 있나요?	있습니다
여기 회원가입하려면 어떻게 하죠?	이쪽 컴퓨터에서 등록 가능하세요
혹시 피씨방 영업시간이 언제까지 인가요?	24시간 영업입니다
물 좀 더 주실 수 있나요?	10분 내로 가져다드리도록 할게요
음료는 객실에 어떤 거를 제공해주시나요?	생수랑 오렌지 주스류는 냉장고에 있고, 부족할 때 말씀해주시면 저희가 채워드려요
외부 음식도 반입이 가능한가요?	저희는 외부 음식 반입을 안됩니다
세 시간에 얼마예요?	5000원입니다
마이크로소프트 오피스 되는 컴퓨터 있나요?	두 대 있는데 모두 사용 중이세요
청소년 이용시간 말씀하시는 거죠?	성인 이용시간이요
인원은 몇 명인 가요?	5명입니다
실내수영장도 없나요?	수영장은 실외만 있어요
회원가는 따로 있나요?	회원가는 700원입니다
네 일단 몇 분이세요?	저희 4명이요
결제할 때 삼성페이 결제가 가능한가요?	삼성페이는 담당자분께 여쭤봐야 할 거 같아요
가격이나 이런 거는 프런트에서 답변을 못 주시는 거예요?	사월 십삼일 토요일 정상가가 이십 일만 이천 원인데, 할인을 해드리면 십팔만 원까지 가능하네요
금연구역은 어디인가요?	창가 쪽은 다 금연구역입니다
당구대는 어떤 걸로 쓰면 되나요?	비어있는 당구대로 가서 치시면 됩니다
이왕이면 조용한 방으로 안내해 주세요	안쪽의 조용한 객실로 드릴게요
결제는 현금으로 해도 되나요?	현금만 됩니다
프린트는 할 수 있어요?	프린트 할 수 있습니다
귀중품 보관 가능하죠?	가능해요
노래방도 있나요?	죄송하지만 노래방은 없어요
회원가랑 비회원가랑 가격 차이는 있는건가요?	조금 차이 있습니다
두 분 맞으시죠?	바비큐 도구는 6시쯤 가져다드릴게요
룸키는 나갈때마다 맡겨야하나요?	룸키는 가지고 다니시고 보관만 잘 해주시면 돼요
가격하고 그런 거는 그쪽으로 문의를 드려야 하나요?	해당 부서가 예약 서비스 팀인데 제가 번호를 알려드릴게요
짐 맡기려고 하는데, 이름은 김유빈이고 연락처는 01033334444인데, 확인 되나요?	약해주신 거 확인되셨어요
청소는 잘 돼있나요?	청결하게 청소되어 있어요
음식 주문도 가능하죠?	음료랑 도시락 주문만 가능해요
기본적인 취사 비품은 뭐가 비치되어 있어요?	취사도구는 다 있고 조미료랑 음식만 사 오시면 돼요
고기도 펜션 내에서 구입이 가능할까요?	고기는 사 오셔야 합니다
어제 예약했는데 지금 입실 되나요?	가능해요
얼마에요?	1박에 8만 원이에요
카드 결제 되나요?	카드기 고장으로 현금만 가능해요
성함이 어떻게 되시나요?	KIM으로 예약했어요
일주일 전이 아니라 2주일 전에 예약해야 하나요?	평소에는 이때쯤 연락해주시면 되는데 이번에만 좀 특별히 빨리 마감된 거예요
퇴실은 몇 시인가요?	다음 날 오전 11시예요
가족 구성원이 어떻게 되시나요?	어른 2명 초등학생 2명 유아 1명입니다
바비큐는 얼마에요?	바비큐는 2인 기준 2만5천원이에요
인원이 몇 명이시죠?	성인 2 아이 2입니다
당구 1시간에 얼마죠?	5000원입니다
선불인가요?	미리 내셔도 되고 가실 때 내셔도 됩니다
조금 할인되는 건 없나요?	제가 만3천원 정도 할인해 드릴게요
흡연실은 따로 되어있어요?	흡연실은 저쪽편에만 있습니다
두 가족이신가요?	두 가족이에요
혹시 PC방 영업시간이 언제까지 인가요?	저희는 24시간 영업합니다
네 명이시면 주차장에서 좀 떨어진 자리 밖에 없는데 예약 계속 진행하시겠어요?	괜찮습니다
지금 지불하나요?	이용하시고 나가실 때 지불하시면 됩니다
네 여기 음료는 선불인가요?	계산하시고 가져가시면 됩니다
방은 따뜻한가요?	개인 온돌이라 조절하시면 돼요
네, 몇 분이 사용하실 건가요?	두 명이 사용할 겁니다
좌석 지정은 어떻게 하나요?	좌석은 미리 지정하는 게 아니고 결제하고 나서 원하시는 자리에 앉으시면 됩니다
삼성페이나 카카오페이도 가능할까요?	삼성페이나 카카오페이도 가능합니다
저희 사구 칠 건데요	당구대 마음에 드는 곳 쓰시면 되세요
여기 어플 같은 거로 할인되나요?	안 돼요
그럼 일단 포켓볼 할게요	3구 자리 나면 안내해 드릴게요
금연 좌석이 있나요?	있습니다
몇 시까지 영업하시나요?	자정까지 영업합니다
장갑은 인원수만큼 해요?	하나만 주시면 됩니다
5명 자리 있나요?	5좌석 있습니다
한 시간만 하고 갈게요	충전은 저쪽 기계에서 해주세요
네, 성함이 어떻게 되시죠?	김철수요
와이파이도 다 있나요?	설치는 되어 있는데 지금 수리 중이여서 사용이 불가하세요
제가 숯불도 예약했었죠?	숯불 예약하셨어요
얼마나 대기해야 할까요?	10분 정도 기다리시면 돼요
숙박할 거예요	일반실이랑 특실이 있어요
트윈룸 맞나요?	트윈룸으로 배정해드렸어요
혹시 여기 비상구는 따로 있어요?	비상구는 따로 있습니다
보문관광단지는 도보로 가능한가요?	보문관광단지는 차 타고 5분 거리인데 차가 없으면 픽업 서비스도 가능해요
조식도 함께 하시나요?	조식 포함해서 토요일 2인실로 예약해주세요
여기 매점도 있죠?	저기 있습니다
정액제가 있나요?	선불 요금으로 있습니다
삼성페이나 카카오페이도 가능하죠?	삼성페이랑 카카오페이도 결제 할 수 있어요
근처에 구경할 만한 곳이 있나요?	보통 경주 시내까지 20분에서 25분 걸려요
하루 숙박하는 데에 얼마죠?	5만 원이에요
체크아웃은 몇 시인가요?	아침 11시예요
오늘 묵을 수 있는 독채 있나요?	오늘 묵을 수 있는 독채는 하나 남아있어요
공항에서 호텔까지 택시비는 얼마 정도 드나요?	택시비는 못해도 만원은 나와요
방이 나란히 붙어있나요?	나란히 있는 방이 없어서 2층과 3층으로 나누어 드렸어요
출력한 용지는 어디서 나오나요?	다 뽑으시고 카운터 쪽으로 오시면 되세요
요금은 한 시간에 얼마정도에요?	회원으로 하시면 한 시간에 800원이고 비회원은 1000원이에요
음식 주문도 가능한가요?	자리에서 컴퓨터키시면 메뉴판이라고 있어서 거기서 주문하시면 돼요
혹시 여기 와이파이는 다 설치가 되어있나요?	와이파이 다 설치되어 있습니다
예전엔 알바분이 해줬는데요?	개인정보 보호를 위해서 이렇게 바뀌었습니다
수영장은 따로 없죠?	수영장은 풀빌라 방에 따로 있어요
이용요금은 10분에 얼마인가요?	10분에 1200원이에요
더블룸으로 예약하셨나요?	스탠더드룸으로 드릴게요
요기요 쿠폰 있는데 사용되나요?	죄송한데, 그 쿠폰은 여기서 사용하실 수 없어요
PC방 앞에 주차해놨는데 괜찮죠?	앞에 주차하셔도 괜찮아요
혹시 흡연 가능한가요?	저희는 모든 방에서 금연이에요
1시간에 얼마에요?	1500원이에요
관광지는 도보로 가능한가요?	도보는 힘들고 관광지는 차로 이동해야 해요
너무 비싼데 개인 헤드셋 가져와서 사용해도 되나요?	개인 헤드셋을 가져오셔서 사용하시는 건 자유입니다
TV도 다 있어요?	TV도 있어요
개인 강습인가요?	개인 강습이에요
방에 청소를 따로 해주시나요?	침구 정리와 객실 청소는 매일 해드려요
얼마죠?	1박에 2만 원이에요
조식은 포함인가요?	조식은 포함되어 있어요
예약자 신분증 주시겠어요?	여기 있습니다
마실 거는 뭐 뭐 있나요?	커피랑 차 있습니다
조식도 제공되나요?	조식으로 간단한 빵과 음료, 과일이 제공돼요
제가 직접 인쇄할 수 있나요?	저쪽 컴퓨터 이용하시면 되세요
시간이 얼마나 걸릴까요?	정확한 시간을 말씀드리긴 어렵습니다
바비큐장은 캠핑장 근처인가요?	근처 바비큐장도 있지만 캠핑장 개인별 지정 자리에서 하셔도 돼요
회원가입할게요	PC에 앉아서 신청할 수 있습니다
음료는 뭐 있나요?	저쪽 냉장고에서 고르시면 돼요
하루에 숙박비가 얼마인가요?	50000원이요
헤드셋 하나 주세요	갖다 드릴게요
날짜가 어떻게 되세요?	오월 사일인데 객실 가격이 어떻게 되나 해서요
결재할 때 카카오페이 가능한가요?	카카오페이는 안 되고 무통장 입금하셔야 해요
회원 가입하면 할인되나요?	회원 가입 시 10분당 1000원으로 할인해드려요
삼월 이십팔일 목요일 말씀이신가요?	삼월 이십팔일 목요일이요
주차장도 혹시 있나요?	타워 주차장이 있어요
오늘은 시간이 없어 사구밖에 이용을 못하겠네요	다음에 오시면 꼭 이용하실 수 있도록 도와드리겠습니다
어린이 한 명 추가하면 가격이 어떻게 되나요?	저희 호텔 기본적인 객실은 최대 인원이 이인이기에, 초등학생 자녀 한 분 추가하시면 추가 요금 만원 발생하세요
몇 분이 투숙하시나요?	연박하면 9만원으로 할인 해서 3일에 27만원이에요
1시간에 얼마인가요?	9천 원입니다
요금은 한 시간에 얼마인가요?	50분에 1000원이에요
삼성 파이로 할게요	여기 단말기 앞에 대주세요
포켓볼 가능한가요?	조금 기다리셔야 해요
이 열쇠 사용하면 되나요?	사용하시고 제자리 부탁드려요
바다 쪽 독채가 있고 산 쪽 독채가 있는데 어떤 걸로 하시겠어요?	바다 쪽으로 주세요
이틀 묵는데 매일 방 청소해주시나요?	매일 방 청소 해드려요
체크 아웃은 몇 시인가요?	오후 한 시에 체크아웃 해주셔야 돼요
방에서 담배 냄새가 나요. 다른 방으로 바꿔주세요	지금 남는 다른 방이 없어서 방 변경은 어려워요
의논을 해보고 다시 전화드리도록 할게요	전화 주시면 이박에 어떤 방을 하시든 이만 원을 할인해 드릴게요
결제 비자카드도 됩니까?	여기 서명 부탁드려요
예약 확인 좀 해주실래요?	패밀리룸 예약 확인되었어요
엘리베이터 어디 있어요?	엘리베이터는 출입문 왼쪽에 있어요
그리고 저희 테이블에 음료수 3개만 주세요	곧 가져다드릴게요
오션뷰와 시티뷰가 있는데 어디로 드릴까요?	오션뷰로 부탁해요
혹시 커플석은 있나요?	커플석 있습니다
조식은 룸에서 먹게 되나요? 아니면 따로 이용할 수 있는 바가 있나요?	일 층에서 저희가 준비를 해드리는데, 원하시면 객실로 가져다드려요
자리 이동 가능한가요?	가능합니다
스타크래프트 설치되어 있나요?	모든 PC에 설치되어 있습니다
바비큐 장비 대여가 가능한가요?	한 세트에 3만 원 요금이 추가됩니다
조식 신청하려고 하는데 어떻게 하죠?	식사하러 가셔서 그 자리에서 결제하시면 돼요
1시간 추가해주세요	추가해드렸습니다
조식은 따로 비용 내야 하는 거죠?	한 분당 15000원씩입니다
10분에 얼마인가요?	천 원입니다
조식은 포함돼있죠?	싱글룸 2박 예약으로 조식 포함되어 있어요
회원가입을 해야지 이용할 수 있나요?	비회원으로도 가능해요
2명 자리 있어요?	자리는 15번 16번 앉으시면 되세요
방 있나요?	방 있어요
현금 영수증 필요하세요?	전화번호나 사업자등록번호 알려주세요
주차할 수 있는 공간은 있나요?	주차할 수 있는 공간은 없습니다
체크인이 언제까지예요?	오후 1시까지 방 비워주시면 돼요
카드로 결제해 주세요	손님, 카드가 잔액 부족이에요
커플석 같은거 있나요?	저기 오른쪽 벽쪽 보시면 커플석 있습니다
차량으로 이동 안 하시고 대중교통 이용하세요?	어떤 게 좋을까, 사장님한테 물어보는 거든요
주차할 수 있는 시설은 있을까요?	건물 주차장이 있는데 공간이 협소합니다
펜션에 편의시설 다른 거 있나요?	특별히 편의시설은 없어요
처음 방문했는데 어떻게 이용해야 하나요?	옆에 자동판매기에서 사용하실 컴퓨터 자리 번호를 누르시고 결제 후 이용하시면 됩니다
바비큐장이 따로 있나요?	테라스가 있어서 바비큐는 거기서 하시면 돼요
그럼 도시락 라면 주문 가능한가요?	자리 가시면 거기서 주문 가능하세요
예약도 가능한가요?	전화로 예약이 가능하십니다
혹시 예약도 가능할까요?	예약은 안 됩니다
카드로 계산해도 괜찮나요?	현금하고 카드 다 가능하세요
시간당 얼마인가요?	2000원입니다
다른 손님들도 바비큐 해 먹고 하나요?	다른 손님들은 지금 없어요, 단체 손님들이 많아요
흡연은 어디에서 합니까?	흡연부스에서 하시면 됩니다
이거 어떻게 입력해야 해요?	가입하시고 충전 누르시면 돼요
혹시 계란 반숙 가능한가요?	총 2500원 되겠습니다
고기를 밖에서 구워 먹을 수 있나요?	사용료가 있어요
장갑 주세요	여기 있습니다
청소년은 몇시까지 출입이 가능한가요?	12시까지 가능해요
VIP 룸으로 예약가능한가요?	그렇게 해드리겠고 짐은 저희 직원이 옮겨드릴게요
사십만원 같으면 하루에 얼마 치지?	만 삼천원이에요.
컴퓨터도 있나요?	방마다 컴퓨터가 설치되어 있어요
카카오페이나 삼성페이도 돼요?	삼성페이는 되는데 카카오페이는 안되세요
4명 1자리 주세요	두 자리 중 원하시는 곳 가시면 됩니다
쓰레기 봉지 5장 정도 제공해주시면 감사하겠습니다	잠시만 기다려 주세요
뭐 좀 물어볼게예?	뭐가 궁금하세요?
조식은 성인 일인이 얼마예요?	조식은 오천 원이고 체크인하실 때 말씀해주시면 돼요
청소년은 몇 시까지 이용할 수 있나요?	19살 이전 나이는 10시 이후에 다 귀가해야 됩니다
왜 안되는 건가요?	인터넷 선이 빠졌네요
사장님, 화장실 어디 있어요?	화장실은 오른쪽으로 가면 나와요
대실 2만 원 맞죠?	대실료는 2만 5천 원이에요
픽업되나요?	픽업 서비스는 하지 않아요
작은방은요?	1박에 3만 원이에요
제휴 할인 카드 같은 건 없고요?	저희가 할인된 요금으로 안내를 해드렸기에 제휴 할인은 중복이 안 돼요. 제휴 할인은 공식 가격에서 할인이 되기 때문에, 안내해 드린 금액과 큰 차이는 없어요
조식은 뭐가 나오나요?	조식은 뷔페식으로 빵도 나오고 한식도 나와요
1시간에 얼마인가요?	한 시간에는 1200원이고 열 시간 충전하시면 10000원이에요
콘도 내에서 고기 구워 먹을 수 있나요?	콘도 내에서는 드실 수 없으세요
시간당 얼마인가요?	1시간당 5000원입니다
얼마인가요?	온돌방은 1박에 6만 원이에요
삼일 연박 가능한데 날짜는 어떻게 되세요?	다음 주 일요일부터 수요일까지요
조식 포함 한 가격인가요?	조식은 따로 비용 결제하셔야 해요
두 분이 각각 방을 쓰시나요?	회사 출장 왔는데 한 명이 여직원이라 그래요
몇 분이세요?	총 여덟명이어서 좀 넓은 방이 필요한데요
라면은 자리에서 주문하나요?	라면부터 음료수까지 자리에서 편하게 주문하실 수 있습니다
이름과 전화번호 뒷자리 알려주세요	이수빈 4567입니다
청소년들은 몇 시까지 이용 가능한가요?	청소년들은 오후 10시까지 이용 가능합니다
음료는 어떻게 주문하나요?	자리에서 화면으로 주문해주세요
이용요금 안내해주십쇼	한 테이블당 10분에 1100원입니다
짜장면 시켜 먹을 수 있어요?	저희 당구장은 음식도 팔아서 외부 음식 반입금지입니다
1박에 얼마입니까?	10만 원이에요
음식같은 것도 주문이 다 가능한가요?	자리에서 음식 주문하시면 되세요
주차할 수 있는 공간같은 건 있나요?	주차장이 있습니다
평일에는 제트스파 얼마에요?	평일은 제트스파 구만원이에요
어떻게 사용하는가요?	비어 있는 자리에 앉으시면 되어요
혹시 여기 피씨방 영업시간이 언제까지 인가요?	24시간 영업입니다
2박 하시는 거 맞죠?	2박이에요
몇 분이서 묵으시나요?	저희는 더블베드 룸 밖에 없어요
조식은 포함되어 있나요?	조식 포함 플랜으로 예약되어 있으세요
지금 자리 있나요?	있어요
빈 방이 있어요?	3개 정도 남아 있어요
몇 분이세요?	한 가족인데 세 명이요
특실은 1박에 얼마에요?	10만 원이에요
와이파이도 다 설치되어있어요?	와이파이도 다 설치되어있어요
스카이라운지 이용에 제한이 있나요?	이용 제한은 없지만 제한 시간은 있어요
그럼 커플석으로 두 자리 주세요	74번 75번 자리 켜드릴게요
오늘 숙박 가능한 방 있나요?	숙박 가능해요
투숙하시려는 인원은 몇 분이세요?	성인 두 명이에요
게임은 어떤게 있나요?	포켓볼하고 사구하고 삼구하고 국제식 대대가 있어요
상의는 좀 해보고 전화 예약을 해야 할 것 같은데요?	상의하시고 전화 주시면 사월 십삼일은 십팔만 원에 예약이 가능해요
산책로만 있어예?	겨울에는 산책로만 운영하지만, 4월부터는 관내 유치원과 연계해서 아이들 체험도 하고, 선생님들이 오셔서 숲 해설도 하고 그래요
캠핑 자리 남은 곳 괜찮나요?	나무 아래라 좋아요
네, 제휴 카드 있으신가요?	신한카드 있어요
음식 배달 시켜도 되나요?	방에서 음식 배달 시키셔도 돼요
여기 몇 시까지 해요?	밤 11시 반까지 영업합니다
4월 13일 주말에 1박 2일로 저희 이용하려고 하는데 요금이 얼마 정도?	자스민 하시면 돼요
음식도 주문할 수 있나요?	PC에서 주문 가능합니다
휴대폰 뒷 번호가 어떻게 되시지요?	4685입니다
네, 그리고 짜장면 하나랑 짬뽕 하나 탕수육 중 하나 주문이요	주문해 드리겠습니다
게임이 실행이 안돼요	확인해볼게요
세면도구는 있나요?	일회용품은 2천 원에 구매하셔야 돼요
음식 주문은 할 수 있어요?	음식 주문 할 수 있습니다
아 그래요?	그렇습니다
혹시 독채펜션 사용 가능한가요?	언제 쓰시려고 하나요?
하루이신 거예요?	하루 예약하려고요
펜션, 어디 보셨는지는 모르는 거죠?	여러 군데를 봐서요
중국집 번호 있나요?	여기로 전화해보세요
성함을 알려주실래요?	이현이라고 합니다
어느 지역에서 전화를 받아요?	본사라서 전화를 서울에서 받고 있어요
그 방은 얼만데요?	방 금액은 십만 원이요
디씨가 된다는 이야기다 그죠?	조금은 할인이 돼요
혹시 스파도 같이 있나요?	룸에 스파는 없고 욕조만 있어요
5만 원짜리 방이랑 6만 원짜리 방 어느 방으로 드릴까요?	5만 원짜리 방으로 주세요
비상구는 어느 쪽에 있어요?	흡연실쪽 가시면 비상구 보이세요
우리 딸하고 여행하려는데 전화 예약이나 인터넷 예약이 가능하죠?	전화 예약, 인터넷 예약 다 가능하세요
지금 자리 있나요?	있습니다
예약하고 왔는데 몇 호실인가요?	10층 올라가셔서 오른쪽으로 첫 번째 방 1001호예요
차 열쇠 드려야 하나요?	프런트에 맡기셨다가 나가실 때 방 번호 말씀하시고 받아가시면 돼요
스위트룸으로 주세요	여기 방 카드키 드릴게요
콜라도 주문합니다	가져다드리겠습니다
가격은 혹시 10분에 얼마정도 나오나요?	중형대는 1400원이고 대형대는 1700원이에요
지금 미리 결제 가능하나요?	계좌이체를 통한 선결제 가능해요
금액 추가하면 조식도 먹을 수 있나요?	인당 1만 원이에요
시간당 얼마인가요?	한 시간에 천 원입니다
몇 분이세요?	3명이요
음식 주문하는 것도 기계로 해야 하나요?	음식 주문은 로그인하시고 자리에 앉으셔서 컴퓨터로 주문하시면 됩니다
몇 분이신가요?	넓은 방은 오천 원 추가 금액이 있어요
일하는 사람 몇 분인데요?	4명이요
10분에 얼마인가요?	1200원입니다
시간당 얼마입니까?	3천 원입니다
얼마에요?	2만 7천 원입니다
어린애가 포함되어 있는데 놀 만한 공간이 있나요?	아이가 놀 만한 곳이 마당은 있는데 놀이터는 없어요
계산할게요	만 원입니다
공항까지 셔틀버스 있나요?	공항 셔틀버스는 없어요
사인 가족이 묵을 수 있는 방 있어요?	온돌 객실 아니면 퀸사이즈 침대 하나랑 더블 사이즈 침대 하나 있는 객실이 있어요
몇 시부터 이용 가능한가요?	오후 8시부터 이용 가능하세요
근처에 맛집이 많아요?	여기는 먹거리가 해산물이 많아 바로 옆에 전복죽, 멸치 찌개, 멸치 회, 장어구이 전문점이 있어요
종목은 어떻게 되어 있어요?	3구, 4구있고 한자리만 포켓볼이 가능하세요
조식은 몇 시인가요?	아침 7시부터입니다
퇴실은 언제까지 해야 하나요?	내일 낮 12시까지 비워주시면 돼요
지금 사용하면 되나요?	바로 사용하시면 됩니다
비상구는 혹시 어디쪽에 있어요?	저기 안쪽 보시면 비상구 보입니다
이 카드로 하면 할인되나요?	이 카드는 할인이 안돼요
사발면은 얼마인가요?	하나에 이천 원입니다
추가금은 나갈 때 지불해도 되나요?	됩니다
고객님 성함 좀 말씀해 주시겠어요?	김철수라고 예약했습니다
고객님 확인해 보았는데 4명 맞으신가요?	맞습니다
스타크래프트 가능한 자리죠?	아뇨 그 자리 스타크래프트 안돼요
인원수는 몇 분이세요?	4명이고 아이들 2명 있어요
한 달 정도 머무를 예정인데요	죄송해요, 지금 장기 투숙 가능한 공실이 없어요
음식 같은 건 배달 시켜서 먹어도 되죠?	배달음식 시켜드시는 건 가능하세요
4구 테이블로 한 개 예약하고 싶어요	진행해드리겠습니다
근처에 ATM기가 있나요?	바로 앞에 있는 편의점에 ATM기가 있어요
수강료 다 합하면 얼마에요?	주 일 회하면 삼십오만 원 정도고 주 이 회하면 사십오만원 정도 돼요
사장님 혹시 서비스 시간 같은 건 없나요?	선불로 12000원 결제하시면 10분 더 드릴게요
숙박비는 얼마인가요?	1박 당 7만 원이에요
방을 좀 보고 결정하고 싶은데요?	침대방 하나 온돌방 하나 있어요
캐라반 이용하려고 하면요?	여기 캐라반은 없어요
부가가치세나 추가 팁이 있나요?	별도로 추가되는 비용은 없습니다
현금하면 할인 안 되나요?	현금으로 결제하시면 10프로 할인해 드려요
네, 어떤 방으로 드릴까요?	더블룸으로 키 드릴게요
픽업 서비스 말씀이신가요?	공항 픽업 서비스요
혹시 4시 반에 가도 들어갈 수 있나요?	들어가실 수 있도록 미리 준비해드릴게요
방은 따뜻한가요?	방은 당연히 따뜻하죠
조식은 따로 비용을 지불해야 하나요?	성인 두 분 조식을 포함하면 일박에 이십팔만구천원이에요
해변까지는 도보로 얼마나 걸리나요?	여기서 해변까지는 도보로 10분 정도 걸려요
여기 화장실은 어디죠?	밖으로 나가서 좌측에 보면 있어요
얼마인가요?	1박에 3만원이에요
대실 가격이 얼마죠?	대실 가격은 25000원이에요
물티슈 하나만 주실래요?	제가 닦아 드릴게요
사월 이십일 일박 이일로 예약이 가능한가요?	일반 스탠다드룸은 지금 트윈은 없고 더블베드 객실이 있어요
시설은 깨끗하고 좋아요?	저희 청소 다 깨끗하게 해요
휴대폰 충전기를 빌릴 수 있을까요?	무료로 대여해드려요
그리고 컴퓨터가 안 켜지는데 확인 부탁드려요	켜지네요
이박 연박 가능한가요?	이박 연박 가능하세요
체크인이나 체크아웃 시간은 몇 시예요?	체크인은 세 시부터 가능하고 체크아웃은 다음 날 열두 시까지예요
헤드폰에서 소리가 잘 안 나오는데 어쩌죠?	다른 걸로 바꿔드리겠습니다
빈 방 있나요	있어요
포켓볼 칠 수 있는 자리 있나요?	저쪽으로 가시면 됩니다
여기 컵라면도 팔죠?	팝니다
여기 갯벌 바로 앞에 씻는 곳이 있나요?	밖에는 간이 시설로 돼있어서 안에 들어오셔서 씻으시는 게 편하세요
퇴실은 몇 시까지인가요?	퇴실은 오전 12시까지에요
사장님 저희 4명인데 왜 큐대가 3개밖에 없나요?	하나 더 가져다드릴게요
삼성페이나 카카오페이도 다 가능한가요?	삼성페이나 카카오페이 가능합니다
열선 깔려있나요?	설치되어 있습니다
네 여기 담배는 어디서 피면 되나요?	2층으로 올라가시면 베란다가 있는데 거기서 피시면 됩니다
회원가입해야 PC사용 할 수 있어요?	회원으로 하실려면 선불결제 하시고 사용하셔야 돼요
조식은 숙박비에 포함되어 있는가요?	아니요, 조식 포함 패키지로 예약을 하시면 일 인당 만오천원으로 저렴하게 이용 가능하세요
5명이 잘  수 있는 방 있을까요?	5명은 좁을 것 같네요
체크인은 몇 시부터 가능해요?	지금 방 비워져 있으니까 언제든지 오시면 돼요
칫솔 치약 세면도구 필요하신가요?	수건 챙겨 드릴게요. 904호로 가시면 돼요
네 의자에 앉아있어도 될까요?	편하게 계세요
금연실로 주세요	1에서 7번까지가 금연석이에요
일반 스탠다드룸은 얼마인가요?	사월 이십일 하면 십사만 삼천원이에요
23일에는 예약 가능한가요?	저희 토요일은 5월 되어야 가능하세요
1시간 이용 요금이 얼마죠?	1500원입니다
차량으로 이동 안 하시고 대중교통 이용하세요?	우리 집은 주차장은 넓어서 차 가지고 오시면 편한데 대중교통 이용하시는 게 비용이 덜 들어요
싱글베드 네 개는 가격이 얼마예요?	쿼드 룸은 삼 층에만 있고 일박에 이십만원이에요 아침 식사도 가능하세요
음식물 쓰레기 버리는 곳도 따로 있나요?	물론이에요
현금으로 할게요	현금으로 결제 도와드릴게요
체크인 시간은 몇 시인가요?	입실은 세시부터 가능하세요
네, 예약하셨어요?	청소 중이니까 기다려주세요
카카오페이 가능한가요?	카카오페이는 안 되고 카드는 돼요
네, 몇 분이세요?	4명입니다
비상구는 다 있나요?	비상구는 두 군데가 있어요
지금 숙박할 수 있나요?	가능하세요
혹시 흡연실은 어디에 있나요?	이 쪽에 흡연실 2곳 있습니다
삼월 이일은 룸이 있나요?	삼월 초에는 예약이 조금 어려우세요
몇 분이신가요?	성인 2명이요
계산은 카드도 가능한가요?	계산은 카드로 가능합니다
몇 분이세요?	방 있어요
3월 16일 토요일 예약 가능할까요?	4명이면 3월 16일에 예약 가능하세요
한 게임에 얼마 정도 하나요?	시간당 계산을 합니다
세면도구나 샴푸나 린스는?	세면도구는 욕실에 다 있어요
조식은 언제입니까?	7시부터 10시에요
1시간 이용 요금이 어떻게 되나요?	8천 원입니다
정수기 비치돼있나요?	정수기는 복도에 있어서 공용으로 사용하시면 돼요
하루에 얼마죠?	하루에 5만 원이에요
정원이 딸려있는 독채인가요?	앞마당이 있어요
대실에서 1박으로 바꾸려면 어떻게 하면 되지요?	금액을 추가하시면 대실에서 1박으로 바꾸실 수 있어요
헤드셋도 빌릴 수 있을까요?	헤드셋 대여 시 보증금 5000원으로 현금 주셔야 됩니다
바비큐 해먹고 싶은데 숯은 어디서 사요?	바로 앞 매점에서 팔고 있어요
기본적으로 구비 된 것 말고 나머지는 별도로 신청해야하나요?	유료로 추가하셔야 해요
1박에 요금이 얼마인가요?	20만 원이에요
몇 명이세요?	4명이에요
와이파이는 설치 되어 있나요?	와이파이도 설치되어 있습니다
두 명입니다	2번에서 치시면 돼요
와이파이 같은 건 다 설치되어있나요?	와이파이 설치 다 됐습니다
커플석이라든지 그런 건 있나요?	커플석은 없습니다
네, 몇 명이신가요?	6명이라서 방 3개가 필요해요
바비큐를 하려면 따로 비용 들어가죠?	바비큐장을 이용하시면 이만 원인데 만 원만 주세요
펜션 내에서 간단한 취사가 가능할까요?	가능해요
바비큐 시설도 이용하고 싶은데요?	미리 예약하시면 당일 준비해드려요
흡연실은 어느 쪽에 있어요?	흡연실은 바로 앞쪽 보시면 있습니다
이틀 동안 머물고 싶은데 빨래도 가능한가요?	로비로 오시면 빨래 서비스 이용 가능해요
4명이서 잠만 자고 갈 건데 방 하나만 빌리면 안 되나요?	법으로 혼숙은 금지되어 있어서 안 돼요
주문해 드릴 수 있는데 주문해드릴까요?	알겠습니다
특실은 얼마에요?	특실은 1박에 8만 원이에요
음료수 무료로 나오죠?	콜라 환타 사이다 있습니다
36개월 미만 아이는 무료죠?	무료입니다
몇 살인가요?	16살이요
정액권 끊어서 할 수도 있나요?	8시간에 만 원이에요
체크아웃은 몇 시까지인가요?	체크아웃은 오전 11시까지 하셔야 해요
삼월 이십육일 예약 가능한가요?	삼월 이십육일 예약 가능하세요
큰방 4개 1박하면 얼마에요?	큰방 4개 1박은 45만원이에요
오션뷰로 방 하나 주실래요?	죄송한데, 오션뷰는 없어요
강아지는 내부에서는 잘 수 없죠?	잘 수 있어요
제가 늦게 도착할 거 같은데 입실이 늦어도 상관없나요?	괜찮아요
여기 4구 한 세트만 주세요	가져다드리겠습니다
저녁에 바비큐도 가능한가요?	시간 말씀해 주시면 숯 피워드려요
미리 예약도 되나요?	예약하실 수 있어요
혹시 와이파이는 다 있나요?	와이파이 있습니다
성인 2분이신가요?	성인 2명과 아기 1명이요
1명 추가해서 얼마인가요?	한 분 추가해서 1박에 7만 원이에요
몇 시까지 캠핑장을 사용할 수 있나요?	펜션 이용객은 12시까지 캠핑장을 이용할 수 있고 그 후에는 캠핑하시는 분들을 위해 이용할 수 없어요
네, 대실 시간은 몇 시간인가요?	오후 5시부터 11시까지 6시간이에요
언제 숙박을 하시나요?	5월 4일부터 5월 6일까지 2박 3일간하려고요
계산은 카드로도 가능한가요?	카드는 다른 당구장도 안될 거에요
혹시 외부음식도 시켜먹을 수 있습니까?	배가 고프면 근처 식당에서 시켜서 먹을 수 있어요
먼저 결제하고 갈게요	결제 도와드리겠습니다
사흘 동안 청소는 몇 번 정도 해주세요?	청소를 요구하시면 하루에 한 번 해드릴 수도 있는데, 이틀에 한 번 하는 게 기본이에요
패키지는 이인 조식이 포함되는 거죠?	패키지는 조식이 포함돼요
PC방에 커플석 있나요?	2인석이 5자리 준비되어 있습니다
거기 혹시 9인실 있나요?	9인실은 없고 10인실로 제공 가능해요
구명조끼 대여는 얼마인가요?	무료입니다 사용 후에 제자리에 두시면 돼요
회원 등록하면 할인이 많이 되나요?	5퍼센트 할인되세요
울진군에 대게 판매하는 곳은 거기서 많이 안 멀어요?	여기는 북부 포항 근처라 가까워요
방 안에 침대가 있나요?	있어요
저녁 시간이 조용해요?	낮에 조용해요. 지금쯤 당구대가 남아서 이 시간에 하면 좋죠
결제는 카드로 해도 되나요?	가능합니다
학생 요금제가 있나요?	학생도 동일하게 성인 요금을 적용하고 있습니다
4월 13일, 1박 2일로 펜션 이용하려고 하는데 요금이 얼마인가요?	성인 2명, 아동 2명은 8만원 정도 해요
대실 비용이 얼마인가요?	현금하시면 만 오천 원, 카드는 이만 원이에요
그다음은 어떻게 해요?	자리 찾고 앉으신 후에 로그인하시면 됩니다
평일에는 가격 할인이 좀 있나요?	평일에는 저희가 이십% 할인해서 예약을 받고 있어요
카드 계산해주세요	3번 당구대로 가시면 됩니다
헤드폰 쓰시나요?	바탕화면에서 스피커 아이콘 더블클릭하세요
재활용 봉지는 안주 시나요?	여기 있어요 캔과 플라스틱 재활용 분리 부탁드려요
결제는 어떻게 하실 건가요?	당일 현장에서 카드로 할 거예요
물티슈도 있나요?	물티슈는 따로 구비되어 있지 않습니다
체크인이랑 체크아웃 시간이 몇 시인가요?	체크인은 세 시부터 가능하고 다음 날 열한 시까지 체크아웃해 주시면 되세요
4명이 같이 앉을 자리 있나요?	두 분씩 나눠서 앉으실 자리는 있어요
객실 중에 단체 파티룸이 있을까요?	저희는 파티룸은 없어요
안압지나 이런 데 보러 갈 때 이용해도 되나요?	관광 이용은 안 되고 펜션 오는 픽업용이에요
1시간에 얼마예요?	회원은 1000원이고 비회원은 1200원입니다
객실 요금만 이십삼만 원이에요?	객실 요금이 이십삼만 원이에요
네, 핸드폰 번호 뒷자리는 어떻게 되세요?	1234입니다
청소년들도 24시간 이용되나요?	밤 10시되면 나가셔야 돼요
3월 중순 평일로 4인 가족이 이용하려면 요금은 얼마 정도 지급해야 하나요?	4인 가족용은 9만원짜리도 있고 10만원짜리도 있어요
혹시 커플석 있나요?	커플석은 따로 없습니다
프론트는 몇 시까지 하나요?	밤 10시 전까지 해요
금연실로 예약해도 비용이 같나요?	금연실이든 흡연실이든 비용은 같아요
네 기다릴게요	감사합니다
체크아웃은 몇 시인가요?	체크아웃은 열한 시까지예요
2인실에 1명 추가하면 얼마인가요?	2인실 기본요금은 5만 원이고 인원 추가시 1인당 15000원이 추가돼요
취사가 되는 방인가요?	주방시설이 있어요
일박 이일이세요?	일박 이일이에요
수건이나 샤워용품은 안에 있나요?	수건과 샤워용품은 객실에 비치되어 있어요
네, 3구 자리 나면 알려주세요	바로 안내해 드리겠습니다
여기 주차시설이나 이런 부분은 있으신가요?	주차장이 여기 밑에 있긴한데 작습니다
주차 공간이 잘 되어있나요?	지하와 지상에 주차장이 있어서 주차 공간은 여유로와요
돈 입금하면 예약 완료인가요?	입금하시면 되세요
지금 바로 사용 가능한가요?	한자리 남아있습니다
오션뷰의 경우 2만 원 추가되는데 괜찮으신가요?	추가 요금 내도록 하겠습니다
네 음료는 따로 사 먹어야 하나요?	즐거운 시간 보내세요
요금 차이가 뭐죠?	일반은 1300원이고 포켓볼은 1500원이에요
아니면은 여기 배틀그라운드는 다 돌아가요?	전 좌석 배틀그라운드 다 돌아갑니다
네 자리 한 개 필요하세요?	두 자리 필요해요
저녁 식사는 몇 시까지 가능한가요?	저녁 9시에 마지막 주문받아요
전화로도 예약이 가능한 거죠?	전화 예약 가능합니다
가장 많은 인원이 들어갈 수 있는 방은 몇 인실 일까요?	최대 4명까지 이용 가능한 가족룸이 있어요
조식은 제공되나요?	조식은 따로 제공되지는 않고 결제를 해주셔야 해요
자차 이동 시에 발레파킹 해주시나요?	주차장 앞에 카운터에서 바로 타워 주차해드려요
커플석으로 부탁드립니다	지금 커플석은 없습니다
바로 고기 구울 수 있게 준비 되나요?	바로 준비해드릴게요
이 금액에 아침이 포함된 가격인가요?	저희는 식사 제공은 없어요
1시간에 얼마인가요?	1시간보다는 정액제로 하시면 더 저렴합니다
몇 시간 동안 머무르시나요?	3시간이요
이불은 충분한가요?	이불이 필요하시면 한 채 더 드릴 수 있어요
1박에 가격이 얼마에요?	6명부터는 큰방 쓰셔야 되는데 1박당 10만 원이요
성함과 휴대폰 번호 끝자리 말 해주실래요?	김땡땡 1234입니다
카드 결제되나요?	카드 결제 가능하세요
큰 방은 얼마죠?	1박에 5만 원이에요
공항이랑 가까운 거리인가요?	공항이랑 가까워서 금방 오실 거예요
흡연실은 어디 있나요?	흡연실은 양쪽에 있습니다
카드로 되나요?	단말기 앞에 카드를 넣어주세요
오락실은 몇 시부터 몇 시까지 이용이 가능해요?	오락실은 이십사 시간 이용 가능하세요
혹시 여기 당구장에 포켓볼도 가능한가요?	5번 테이블은 포켓볼 가능해요
펜션에 어떤 시설이 갖춰져있나요?	수영장 월풀 등 고급 시설이 구비되어 있어요
5명 같이 앉을 수 있는 자리 있나요?	저쪽으로 가시면 있습니다
춘천역에서 가려고 하는데 걸어서 얼마나 걸려요?	걸어서는 오래 걸리고 택시 타고 오시는 게 빠르실 거예요
주차는 어디에 하나요?	방 앞에 하시면 돼요
주중에는 예약 많지 않죠?	주중에 오려면 아빠가 휴가를 써야 되니까요
상의를 조금 더 해보고 전화를 드리도록 하겠습니다	전화 주세요
온라인 예약은 어떻게 하나요?	온라인 예약은 야놀자에서 하시면 돼요
숙박비 얼마죠?	장기투숙 숙박비는 한 달에 백만 원이에요
수건 좀 더 주실 수 있나요?	우측 선반에 여분의 수건이 있어요
지금 방 있나요?	방 있어요
덱을 두 자리로 예약해 드릴까요?	차도 두 대입니다
엑셀로 자료를 뽑으려면 시간당 제가 돈을 드려야 되나요?	저는 비회원이에요
외부 음식 같은 것도 시켜 먹을 수 있나요?	배달 책자 필요하시면 말씀하세요
5월 4일에서 5월 6일 2박 3일간하고 싶은데 어떤 방이 남아있나요?	그 날은 예약이 꽉 차있어요
체크인 시간은 몇 시이고 체크아웃 시간은 몇 시인가요?	체크인은 오후 두 시고 체크아웃은 오전 열한 시까지예요
구로역 말고 신도림역에서 픽업은 안 되나요?	신도림역에서는 픽업이 되지 않아요
제휴 할인 카드는 따로 있나요?	할인 카드는 없어요
카드 계산되나요?	가능합니다
당일날 취소 건이 있는지 잘 모르는데 계속 전화를 해보는 수밖에 없나요?	오월 오일 오전이나 하루 전에 연락을 한번 주시면 취소 건이 있는지 확인을 해보고 예약을 도와드릴 수밖에 없어요
방에 세면도구가 구비돼 있나요	세면도구는 구비되어 있어요
바비큐는 몇 시부터 되나요?	5시부터요
체크인을 위해서 신분증과 카드를 주시겠어요?	엘리베이터 타시고 5층 504호로 가시면 돼요
카드 결제되나요?	카드 결제 돼요
회원가입은 꼭 해야 하나요?	회원가입 없이 비회원으로 결제하셔도 됩니다
만약에 어른들끼리 오면 지금처럼 날씨 이래도 주말에도 성수기처럼 7만원씩인가요?	주말에도 성수기처럼 7만원입니다
20분 정도 기다리시면 자리가 날 텐데 기다리시겠어요?	기다리겠습니다
전문적으로 알려주는 당구장은 한 번씩 치는 데는 얼마나 들어가요?	여기서는 알 수 없고, 그 쪽 당구장에 가서 물어보셔야해요
4인실에 개인 수영장이 있나요?	4인실은 프라이빗 수영장이 따로 있어요
방은 깨끗하겠죠?	매일 대청소를 하기 때문에 방은 깨끗해요
다음 주 토요일로 예약하려고 하는데 가능할까요?	가능해요
모르는 게 있으면 다시 질문드릴게요	언제든지 물어보세요
체크아웃은 언제까지 하면 되나요?	다음 날 오후 12시까지 해주셔야 해요
사장님 포켓볼 있나요?	지금 자리가 꽉 차서 기다려야 하는데요
카드 결제 가능한가요?	카드 결제 가능하십니다
화장실은 어디에 있나요	나가셔서 좌측에 있습니다
바비큐 재료는 저희가 구매해서 가지고 가야 하죠?	바비큐 재료는 가지고 오셔야 해요
네, 숙박 원하세요?	하루 숙박은 7만 원이에요
흡연실 이런거 구비되어 있나요?	흡연실 다 있습니다
3분이신가요?	3명이요
어떤 방을 원하시나요?	저희 모텔은 모든 방에 와이파이와 컴퓨터가 설치되어 있어요
인원이 어떻게 되시죠?	어른 둘 아이 둘입니다
제 친구가 당구장이 처음이라고 하는데 알려주실 수 있나요?	저희 직원이 룰 안내해드릴 테니 잠시만 기다려주세요
애완견 저희가 데리고 가면 안 되나요?	애완견은 출입이 불가능하세요
비치되어 있는 타월 말고 추가로 3장 더 주실 수 있나요?	그럼요. 603호로 3장 더 보내드리겠습니다
바비큐는 서비스고 다른 취사도구는 당연히 있죠?	취사도구는 다 준비되어 있어요
저희가 상의해보고 전화드리도록 하겠습니다	전화 주세요, 감사해요
4구 주세요	알겠습니다
조식 시간이 어떻게 되나요?	이른 아침 비행 손님들도 많은 관계로 새벽 6시부터 10시로 운영하고 있어요
네 그럼 5분 후에 제육볶음 세트 한 접시 제 자리로 가져다주세요	음식 주문은 좌석에서 온라인으로 주문하셔야 됩니다
층수는 몇 층인가요?	현재 남은 방은 9층과 13층이 있어요
스타 되는 자리가 어디예요	A 구역은 다 설치되어있습니다
저녁에 바비큐 해 먹고 싶은데 가능한가요?	당일 오전에 미리 말씀해주시면 준비해드려요
화장실은 어딘가요?	건물 밖에 오른쪽으로 가시면 있습니다
이번 주 토요일 말씀하시는 거죠?	삼월 구일 토요일이에요
바비큐도 할 수 있나요?	바비큐 이용할 수 있고 스파도 방마다 다 있어요
성인이신가요?	성인 맞습니다
칫솔은 안에 있나요?	기본용품은 별도로 천 원에 사셔야 해요
텐트 한 동 치는데 얼마에요?	사이트마다 가격이 달라요. 평일에는 만원에서 삼만원 사이고, 주말에는 만오천원에서 삼만오천원 사이에요
음식 주문은 어떻게 하나요?	바탕화면에 보면 음식 주문 프로그램이 있습니다
네 그러면 화장실은 어디인가요?	2층 베란다 옆에 바로 남자 화장실 있습니다
무료로 제공되는 음료 같은 것도 있나요?	저희가 생수만 인원수에 맞춰서 제공해드립니다
삼성페이 결제 가능한가요?	삼성페이 결제 가능하세요
요금은 어떻게 되나요?	10분에 천 원입니다
퇴실 시간은 몇 시인가요?	12시예요
관광지는 도보로는 갈 수 없죠?	차로 이동하셔야 해요
회원제가 따로 있나요	운영하고 있습니다
개인 큐 써도 되죠?	가능합니다
현금이 없어서 입금해드려도 될까요?	계좌번호 알려드릴게요
할인되는 카드나 제휴 할인 카드 있나요?	할인 카드, 제휴 카드 없어요
3구로 주실 수 있나요?	3구 드리겠습니다
원래는 주말에 방이 얼마쯤 해요?	원래는 10만원 중반대부터 20만원 후반대까지 있어요
혹시 프린트도 가능한가요?	프린트할 거 정해지시면 누르지 말고 저 불러주세요
이 카드는 어떻게 사용하죠?	컴퓨터를 켜시고 나오는 화면에 카드 번호를 입력하시면 됩니다
도심 쇼핑몰로 셔틀버스 운행하나요?	정문에서 30분마다 탑승하실 수 있어요
대실이신가요, 숙박이신가요?	지금은 방이 다 차서 숙박은 어려워요
퇴실 시간을 늦출 수 있나요?	시간을 늦추어도 오후 3시까지는 퇴실 하셔야 해요
당구공이 걸려서 안 나와요	처리하는데 시간이 걸리겠는데요
오월 첫 주라고 말씀해주셨나요?	오월 첫 주에요
정액제 만 원 충전하면 몇 시간이에요?	12시간입니다
방 예약했는데, 확인 되나요?	룸은 7층 721호예요
바비큐장 가격은 어떻게 돼요?	바비큐장 사용료는 3만 원이에요
아동이 몇 살인가요?	아이는 8살, 6살이에요
4명이 같이 묵을 수 있는 방 있나요?	좀 넓은 방으로 드릴게요
대실이 얼마죠?	일반룸은 30000원이고 럭셔리룸은 45000원이에요
몇 시부터 입실 가능한가요?	4시부터 입실 가능하세요
몇 분이신가요?	3인 예약 가능하세요
카카오페이나 삼성페이도 가능할까요?	카카오페이나 삼성페이로 계산 가능합니다
단체 예약 가능한가요?	20분 이상 투숙 시 가능해요
조식은 몇 시부터 제공하나요?	오전 7시부터 제공해요
이 가격에 조식이 포함되나요?	저희가 조식은 없어요. 취사시설은 다 되어 있어요
화장실은 어디 있나요?	나가서 오른쪽으로 가시면 됩니다
요금은 한 시간에 얼마 정도예요?	한 시간에 1000원입니다
방 있나요?	있어요
예약 된 방 몇 층인가요?	3층 302호예요
이용요금이 어떻게 되나요?	10분에 천 원입니다
세면도구는 다 구비가 되어 있나요?	칫솔까지 다 구비가 되어 있어요
대구에서 오시는데요?	대구에서 출발해요
예약했는데 이른 체크인 가능한가요?	죄송해요, 체크인은 두 시간 후부터 가능해요
토요일이시죠?	토요일 예약하려고요
배달 음식 시켜도 되나요?	가능합니다
포켓볼 자리 있나요?	빈자리 가서 사용하시면 됩니다
나중에 짜장면 주문도 하려고 하는데 여기로 배달도 가능하나요?	주소는 여기로 주문해 주시면 됩니다
엘리베이터는 어디에 있죠?	엘리베이터는 이 복도 끝에 있어요
삼성페이도 가능한가요?	원래는 가능한데 지금 기계가 고장이 나서요
내일 체크아웃은 언제까지 해야 하나요?	오전 11시까지 부탁드려요
몇 분이 서 사용하실 건가요?	그럼 스탠더드룸 하시면 충분하실 것 같아요
여기 PC방 프린트되나요	됩니다
여기 컴퓨터 사양 배그 돼요?	고사양 컴퓨터입니다
주차할 수 있는 공간이 있나요?	주차장은 따로 없습니다
다른 날로 예약을 할 수 없는 건가요?	죄송하지만, 다른 날은 예약이 마감되었어요
음식은 어떻게 시키는 거죠?	자리에 앉으셔서 화면을 켜면 메뉴판이 나와요
성인 두 분 디럭스 더블룸 맞으세요?	맞아요
배달시키려고 하는데 주변에 맛있는 가게 있나요?	큐대 옆에 전단지 붙어있어요
어디를 통해서 예약하셨나요?	소셜커머스에서 예약했어요
대실 시간은 몇 시간이죠?	대실 사용시간은 4시간이에요
여기 10만 원 드릴게요	2만 원 거슬러드릴게요
결제는 어떻게 하나요?	홈페이지에 나와있는 계좌로 입금하시고 글 남겨주시면 돼요
몇 분이세요?	가족 총 6명이 갈 거예요
체크인은 몇 시부터예요?	토요일 보통 두 시인데 조금 일찍 온다고 미리 말씀하시면은 한두 시간 이르기도 돼요
사우나를 이용할 수 있는 시간이 따로 있죠?	사우나는 아침 다섯 시부터 밤 여덟 시까지 해요
오렌지 라임 방, 주말 이용요금은 얼마에요?	오렌지 라임 방은 주말에 13만원이에요
방 키 하나 더 주실 수 있나요?	보증금 만 원이에요
차량 번호 알려주세요	5052입니다
대구에서 출발하면 픽업 가능한가요?	4시까지 되는데 경주월드하고 불국사에서 픽업해요
자리 있어요?	카드 받아 가세요
여기 한 시간에 얼마였죠?	4000원입니다
혹시 핸드폰 충전기 빌릴 수 있나요?	핸드폰 충전기는 방에 비치되어 있어요
혹시 여기 주차시설이라든지 그런 부분은 있을까요?	주차장이 있습니다
비상구는 어디 있나요?	비상구는 좌측에 있습니다
컵라면 주세요	라면 값은 선불인데요
배달음식 시켜도 되나요?	가능합니다
열 장이면 삼천 원인데 컴퓨터 쓰는데 얼마 드려야 되죠?	비회원은 한 시간에 팔백 원이예요
바비큐 같은 거는?	4명이면 숯과 그릴 드리는데 2만원이에요. 고기는 사 오셔야 하고 양념은 다 있어요
오 박사 고객님 2일 예약하셨는데 맞으신가요?	맞습니다
그럼 나가서 필 때 시간은 그냥 계속 가나요?	잠깐이면 그냥 두셔도 되고 아니면 일시정지하시면 시간이 멈춥니다
사구 있나요?	있습니다
방은 몇 개인가요?	1개예요
조식 포함해서 2박 예약 되나요?	그럼 총 10만 원 결제해드릴게요
프린트도 해야 되는데 프린트기는 어디에 있나요?	사용하실 컴퓨터에서 인쇄를 하면 카운터에 있는 프린트기로 인쇄되고 1장에 300원입니다
커플석이라든지 이런거는 있나요?	커플석 있습니다
연계된 렌터카 회사가 있나요?	아니요, 연계된 렌터카 회사는 없어요
이렇게 아무리 눌러도 인식이 안돼요	그러면 제가 다른 자리로 바꿔드릴게요
네, 내일 예약이신가요?	내일 디럭스방으로 두 명이요
며칠 머무르실 예정이신가요?	1박 2일입니다
침구세트는 추가하시나요?	침구 3세트 추가해주세요
공휴일에도 영업하시나요?	공휴일에도 쉬는 날 없이 영업합니다
사월 말에 못 가면 오월 초에 가려고 하는데, 그때도 사월이랑 요금이 똑같나요?	오월 초는 요금이 달라져요
와이파이는 혹시 다 되어있어요?	와이파이는 다 되어 있습니다
화장실은 어디에요?	저쪽에 있어요
이거 과자는 카운터에서 사나요?	이쪽으로 오세요
방은 깨끗하지예?	.
방 있나요?	일반방은 꽉 찼고 프리미엄 방만 있어요
이용요금은 10분에 얼마에요?	1500원이에요
사장님 혹시 흡연장 있나요?	흡연장은 화장실 왼쪽에 있어요
인원이 한 명 추가되었는데 얼마 더 추가되나요?	만 원이에요
3구요	지금 3구 자리가 없어요
정액권 끊다가 정지해도 되나요?	가능합니다
텐트를 대여해서 사용하려면 어떻게 해야 하나요?	캠핑장 예약 시 텐트가 필요하다고 말씀해주시면 돼요
며칠 계실 예정이세요?	2박 하려고요
4월 20일 예약 가능할까요?	가능해요
혹시 컵라면도 있나요?	종류별로 있습니다
네, 어린이 동반한 4인인가요?	성인 4인이요
시간 연장 가능하나요?	다음 손님이 없으면 연장이 가능해요
대 다이 있나요?	대 다이는 지금 다른 손님이 사용하고 계세요
우리 애가 당구를 배우고 싶다 하는데,여기 당구장 가라고 하더라구요?	여기 잠깐 앉으세요
체크인이 조금 다른 데 보다 늦네요?	다른 호텔도 체크인은 세시 아니면 네시에요
혹시 와이파이 같은 건 설치되어 있나요?	당연히 와이파이 설치되어 있습니다
가족인데, 그럼 방 두개 해야해요?	두개 하셔야 돼요
바다 쪽 뷰 꼭 원하시나요?	바다 쪽 이면 좋습니다
9인실 예약 하려는데요?	예약해드릴게요
한 시간 요금은 혹시 어느정도에요?	회원은 600원 비회원은 700원이에요
이 시간이 보통 조용하고 저녁에는 어때요?	다섯 시쯤 되면 보통 손님들 차죠
포카리스웨트 2개만 꺼내 먹을게요	3000원입니다
2박 예약한 이민우인데, 체크인 시간이 몇 시인가요?	3시부터에요
흡연실은 어디인가요?	화장실 옆에 있습니다
같은 층으로 해서 방 2개 있을까요?	바로 옆방만 아니면 드릴 수 있어요
현금으로 할게요	현금영수증 발급해드릴게요
성함이 어떻게 되시죠?	김동현입니다
주차할 수 있는 시설도 있구요?	주차시설 있습니다
머신은 어디 있나요?	입구 좌측에 있습니다
주차할 공간은 있나요?	PC방 주위에 주차장은 있는데 몇 대 주차 못합니다
거기는 바비큐 고기 얼마인가요?	삼겹살 한 근에 3000원이요
계산은 혹시 카드로도 결제가 가능할까요?	카드로 계산 가능합니다
카드로 결제되나요?	그렇군요
삼성페이나 이런거도 다 결제 가능한가요?	삼성페이나 이런 전자결제로 결제 가능합니다
예약이라던지 이런 부분도 가능해요?	가능한데 아직까지는 예약하시는 손님이 없었어요
음식도 주문이 가능한가요?	자리에서 음식 주문하시면 돼요
체크아웃 시간은 언제인가요?	오전 10시예요
바비큐용 고기는 어떤 걸 팔아요?	목살하고 삼겹살 있어요
비상구는 혹시 어느 쪽에 있나요?	비상구는 저쪽에 있습니다
룸에 침대 2개 있나요?	더블 침대 2개 있으며 원하시면 싱글 침대 4개로 준비 가능해요
아이들 조식 비용은 따로 지불해야 하죠?	아이들 조식 비용은 현장 결제해 주시면 돼요
8일부터 12일까지 네 명 예약하고 싶은데요?	4인 기준 삼 박 사 일 캠핑장 이용료는 12만 원이에요
그리고 신라면 하나 주세요	2천 원 현금결제입니다
얼마나 기다려야 할까요?	지금 게임을 시작하셔서 조금 오래 기다리실 것 같습니다
룸 가격에 조식은 포함된 건가요?	조식은 정 인원에 무료로 제공을 해드리고 있어요
대가족이 이동해서 귀중품 보관도 가능한가요?	귀중품 보관 가능해요
현금으로만 결제 가능한가요?	오직 현금으로만 결제 가능합니다
어떤 방 찾으세요?	전망 좋은 방으로 부탁해요
3구로 할게요	큐대는 오른쪽에 걸려 있습니다
입실시간 보다 일찍 왔는데 입실 가능할까요?	라벤더방은 입실 준비가 덜 되어 있어 30분만 기다려주세요
방으로 부탁드립니다	안내해드리겠습니다
제가 인수하고 싶은데 사장님과 연락 가능한가요?	제가 사장입니다 불가합니다
예약하고 왔는데요?	확인되었어요
자판기는 어디 있나요?	나가서 바로 오른쪽을 보시면 있습니다
여기 가입은 어떻게 하나요?	화면 안에 회원가 임란을 누르시면 됩니다
내일도 예약이 다 차있나요?	내일, 모레까지 예약이 꽉 차 있어요
네, 성함이 어떻게 되시나요?	김민정이에요
방 나눠서는요?	큰방 4개는 쓰셔야 해요
평일로 1박 2일 정도 이용하려면 요금이 얼마예요?	평일 4인은 24만원이에요
바깥에 있는 바비큐 자리는 추가요금 없이 이용할 수 있나요?	숙박요금에 포함된 부분이에요
결제는 카드로 할게요	카드 받았습니다
네, 몇 명이세요?	4명입니다
오류사항 없으시고 카드 선결제 해드릴까요?	카드로 해주세요
그 방으로 주세요	6인실은 1박에 8만 원이에요
오늘 캠핑장에 특별한 행사는 없나요?	바비큐장에서 통기타 연주가 있을 예정이에요
야외 바비큐장 사용 가능한가요?	사용 가능해요
예약하신 분이신가요?	약 안 했고 1박에 얼마인가요?
포켓볼 다이 있나요?	안내해 드릴게요
커플석같은 거는 있나요?	커플석은 따로 없습니다
계산은 선불로 하시겠습니까	알겠습니다
바비큐는 미리 예약해야 하나요?	그날 오셔서 주문하시면 돼요
좀 더 큰 방은 없을까요?	6인실 방이 있어요
원하시는 객실 타입 있으신가요?	어떤 룸이 좋은지 소개 좀 해주세요
방 에어컨이 고장 난 거 같은데 한번 봐주시겠어요?	방으로 바로 갈게요
오렌지 라임 방 보시겠어요?	설명 간단하게 해주세요
냉장고하고 다 있죠?	냉장고는 방에 있어요
가격이 얼마에요?	10분에 1200원입니다
몇 시부터 입실이 가능한가요?	오후 2시부터 가능해요
디럭스 패밀리룸 이용 요금은 어떻게 되나요?	디럭스 패밀리룸 같은 경우 삼월 삼십일이 토요일이라 십팔만원이에요
할인 쿠폰 사용 가능합니까?	주말은 사용할 수 없습니다
마세 되나요?	300 이상은 가능합니다
네, 고객님 어떤 날짜 원하시나요?	4월 5일에서 7일까지 2박 3일 가능한가요?
자리 연속 2개 있나요?	25번과 26번 자리가 있네요
호텔에 묵게 된다면 편의시설은 어떤 거 있나요?	저희는 아침 식사 바, 커피숍이 있어요
그럼 10시간 할게요	12000원입니다
아이스티는 얼마인가요?	1500원입니다
십육 일 일박 이일로 이용요금이 얼마 정도 되나요?	주말, 두 분이시면 십구만원 방이 있어요
종목은 어떤게 있나요?	삼구하고 사구하고 포켓볼 등 여러가지 있어요
결제는 카드로 하시나요?	계좌이체 가능할까요?
청소년들은 몇 시까지 이용할 수 있나요?	10시까지 이용할 수 있어요
애들은 온천 요금 얼마에요?	애들 온천 요금은 4천원이에요
제가 어떻게 하면 될까요?	모니터가 이렇게 가방에 걸리네
몇 명이신가요?	성인 둘, 아이 둘이에요
여기 프린트는 가능한가요?	프린트 가능합니다
한 시간에 얼마인가요?	7000원입니다
네 어떤 걸로 준비해드릴까요?	콜라 하나랑 커피 두 잔 주세요
캠핑장에 편의시설은 뭐가 있어요?	캠핑용품점과 편의점이 있어요
작년에는 얼마쯤 했어요?	홈페이지에 들어가면 실시간 예약 가격이 나오는데 지금 그 가격이랑 비슷했어요
지금 예약해주시겠어요?	잠시만 기다려주세요
커플석도 있나요?	오른쪽 끝 쪽에 다섯 자리 있습니다
방 이름이 뭐였어요?	원룸 방 두 개 있고 거실 있는 방, 복층 방도 있어요
현금영수증 되나요?	번호 불러주세요
회원가입을 해야지만 이용이 가능한가요?	비회원으로도 할 수 있습니다
주차할 수 있는 곳은 있나요?	건물 주변에 유료주차장이 있는데 거기에 주차하시면 돼요
조식도 제공이 되나요?	오전 9시부터 10시까지 무료로 제공해요
조식 룸서비스도 가능한가요?	조식도 룸서비스 가능해요
몇 층인가요?	맨 윗층이에요
몇 분이신데요?	두 명입니다
관광지는 도보로 가능해요?	관광지는 도보로는 못 가고 차를 이용하셔야 해요
삼성페이나 카카오페이도 가능한가요?	페이로 결제하시는 것도 가능하세요
이용할 수 있는 편의시설은 어떻게 되나요?	저희가 비즈니스호텔이라 조식하고 일 층에 커피숍이 있어요
음료 주시나요?	가져다드릴게요
바다가 보이는 방이 있나요?	두 개의 방이 있어요
돈가스 주문하면 얼마나 걸리죠?	대략 20분 정도 걸립니다
오늘 예약 가능한가요?	지금 예약 가능하세요
3시간 가능하죠?	편하신 곳에 앉아서 하시면 됩니다
PC방 영업시간이 어떻게 되나요?	영업시간은 24시간이에요
카카오페이도 가능한가요?	따로 카카오페이를 하고 있지는 않아요. 실시간 예약으로 '야놀자'나 '떠나요'에서 카카오페이가 돼요
바비큐장을 이용하고 싶은데 따로 예약을 해야 하나요?	미리 말씀 주셔야 해요
어떤 방으로 원하세요?	프리미엄룸은 다 나갔고 스위트룸만 남았어요
그리고 컴퓨터가 안 켜지는데 확인 부탁드려요	아 콘센트가 빠져있네요
몇 시에 오시려고요?	4시쯤으로 3박 예약해 드릴게요
픽업 오시면 언제쯤 도착하시나요?	20분 정도 걸릴 것 같아요
여기 1시간 이용료는 얼마죠?	한 시간에 1000원입니다
음식은 주문 가능하고요?	자리 가셔서 음식 시키시면 됩니다
룸서비스가 가능한가요?	저희는 중소형 호텔이라 룸서비스가 없어요
이용요금은 10분에 얼마에요?	국제식 대대와 포켓볼은 10분에 1700원이에요
몇 인실 원하시나요?	저희가 현재 4인실은 예약이 다 차있는 상태예요
요금은 한 시간에 얼마 정도 인가요?	요금은 한 시간에 1000원입니다
삼월 십오일 예약이 가능한가요?	삼월 십오일 금요일, 가능하신 객실은 싱글베드 두 채 있는 호텔 할리우드 방이 있어요
근처에 식당은 하나요?	바로 앞에 이분만 걸어가면 함양식당이라고 유명한 집이 있어요
혹시 다른 이름으로 하신 건지 확인 해 주실래요?	다시 보니 신랑 이름으로 예약했네요
전자레인지나 인덕션 있는 객실이 있나요?	인덕션 있는 객실은 콘도 타입으로 간단하게 조리해서 드실 수 있고, 금액이 십이만 원이에요. 전자레인지는 칠층 복도에 비치가 되어있어서 이용 가능하세요
음료는 어떻게 주문하나요?	메뉴판에서 고르시고 말씀해 주세요
비상구는 어느 쪽에 있을까요?	카운터 쪽에 하나 있고 화장실 옆쪽에 하나 있어요
바비큐 준비를 해서 가야 하는 거죠?	마트나 시장 가서 드실 거 준비해 오셔야 해요
고기 구워 먹을 바비큐 시설이 있나요?	바로 앞에서 가능해요
성함이 어떻게 되시나요?	김보람이요
금연 자리로 주세요	결제는 나가실 때 해주시기 바랍니다
각각 3천원씩 넣어주시겠어요?	저희 피시방은 뒤에 있는 기계로 직접 시간 충전하시면 됩니다
지하에 주차하면 무료인가요?	무료입니다
네, 방금 전화 주신 분 맞으시죠?	오늘 1박 2일 예약했는데요
회원가입해야 하나요?	해야 가능하십니다
어린이 2명 포함 총 5명인데 2박 3일 이용 가능한가요?	가능해요
네, 오늘부터 2박 더블룸으로 예약 확인되셨고 금액은 20만 원이에요	카드 결제 도와드릴게요
흡연구역은 따로 없나요?	여기는 금연 PC방입니다
숯만 준비해주시는 건가요?	간단한 소금 쌈장과 장갑 집게 같은 도구도 빌려드려요
카카오페이 가능한가요?	입금하시고 당일 환불 후, 카드 결제 가능하세요
6명인데 20% DC 해주시나요?	할인은 토요일은 안 되고 평일만 가능해요
혹시 주차할 수 있는 시설은 있을까요?	주차 시설은 없습니다
텐트가 빅 사이즈랑 미디엄 사이즈 있는데 어떤 거 하시겠어요?	빅 사이즈요
혹시 신분증 보여주실 수 있으신가요?	여기 있습니다
소개받고 전화드렸는데요, 체크인 시간이 몇 시인가요?	세 시에 오셔도 되고 좀 일찍 오시면 두 시쯤 오셔도 돼요
청소년들은 이용시간이 몇 시까지에요?	밤 10시까지 이용하실 수 있어요
저희가 쓸 펜션은 몇 호인 가요?	고객님이 머무르실 펜션은 언덕 위에 있는 5호실이에요
펜션 앞에 바비큐 그릴 준비되어 있나요?	만원 추가하시면 이용 가능해요
이영희로 예약했는데, 확인 좀 해주실래요?	죄송한데, 예약자에 이름이 없어요
바비큐 이용은 얼마인가요?	25000원이에요
바비큐 지금 예약하면 내일 먹을 수 있나요?	내일 먹을 수 있어요
2박에 15만 원, 괜찮으세요?	좋아요
카라반 이용시 화장실은 어떻게 이용하나요?	카라반 내부에 화장실이 있어요
초등학생은 추가 비용 있어요?	초등학생도 성인과 마찬가지로 일 인당 추가할 때마다 만 원이요
A 로봇으로 예약해 주실래요?	A 로봇 이름으로 A 사이트 예약되셨습니다
애완견 동반 가능한가요?	죄송하지만, 애완견과 동반 캠핑은 불가능해요
포켓볼은 있나요?	포켓볼대는 구석에 2대있어요
가방을 꺼내다가 모니터를 건드려서 깨버렸네요	저도 CCTV로 봤습니다
여기 pc방 복사 가능한가요?	복사 가능합니다
몇 시까지 문열어요?	한 시까지 하고 있어요
계산은 어떻게 하죠?	저희는 10분 당 900원입니다
체크아웃이 몇 시죠?	체크아웃은 11시 30분입니다
욕실이 있고 좀 넓은 방 원하는 데 있을까요?	넓은방 있어요
며칠이죠?	5월 5일이요
네, 그러면 포켓볼이 사구보다 천원 더 비싼 거 아시죠?	알고 있어요
날짜는 언제로 예약하시고 싶으세요?	다음 주 금요일부터 월요일까지요
어느 사이트로 예약하셨나요?	쿠팡에서 예약했어요
1시간에 얼마인가요?	처음 1시간은 1000원이고 이후 1시간은 500원씩 추가됩니다
몇 분이 서 사용하실 건가요?	두 명에서 세 명 정도요
회원가입은 어떻게 하는 거죠?	자리에 앉으셔서 pc로 하시면 됩니다
교직원 공제 회원이세요?	교직원 공제 회원 아니에요
얼마나 걸리나요?	20분 정도 기다리셔야 해요
네, 뷰가 좋은 방이 마침 있는데, 예약 진행 해드릴까요?	결제할게요
숯하고 삼겹살 두근 주실래요?	잠시만요
예약번호 알려주세요	1234567입니다
포켓볼도 게임 가능한가요?	포켓볼은 바로 시작할 수 있습니다
카드로 할게요	주세요
햄버거와 콜라 하나 주세요	여기 있습니다
결제할 때 카카오페이로도 가능한가요?	죄송하지만 카카오페이는 안 돼요
회원가입을 안 해도 사용이 가능한가요?	회원가입을 안해도 사용 가능합니다
사장님 여기 얼마에요?	1시간에 3000원입니다
음식물은 어떻게 하죠?	개수대 있는 쪽에 음식물 통 있어요
이틀 연속 자야해서요 조금 더 DC해 줄 수 있나요?	금,토요일은 DC자체가 되지 않아요
그럼 어떻게 하죠?	따로따로 결제하세요
금연석인가요?	금연석입니다
만 원 충전해주세요	회원 가입 후 말씀해주시면 충전해드리겠습니다
짜장면 2개 준비해주세요	바로 준비해드리겠습니다
세 명이서 치려고 하는데 각자 요금을 내야 하나요?	한 당구대를 1시간 이용하는 금액이에요
결제는 선불인가요?	선불이에요
어떤 종류의 방에서 숙박 가능한가요?	28일에는 2인실과 4인실 모두 예약 가능하세요
청소년들은 몇 시 까지 이용이 가능한가요?	9시까지인데 이후에는 보호자가 있으면 괜찮아요
어떤 방으로 드릴까요?	일반 2인실로 대실 예약해 드릴게요
현금이 없는데 계좌이체 가능할까요?	계좌번호 여기 있어요
음식값은 게임 끝나고 나갈 때 한꺼번에 계산해도 될까요?	그렇게 하셔도 됩니다
식사 주문도 가능한가요?	모니터 화면 참고해주세요
근처에 편의점이 있을까요?	걸어서 5분 정도 가시면 편의점이 있어요
더블 침대 하나에 싱글 침대 하나 있는 전망 좋은 디럭스 타입 객실이 있는데, 자녀분이 나이가 어리신가요?	대학생이에요
2인실로 예약 할 수 있나요?	2인실은 예약이 전부되어있어서 불가능해요
바비큐장 이용할 수 있나요?	바로 앞 테라스에서 바비큐 이용할 수 있어요
저희가 조금만 상의해보고 전화드리도록 하겠습니다	전화주시면 33만선으로 해드릴게요
음식 주문은 자리에서 가능한가요?	감사합니다
자녀분이 몇 살이신데요?	대학생인데요
아드님이 당구를 한 번도 쳐본 적은 없죠?	아, 그러시면 우리 프로 선생님이 계신데 그분이 레슨을 하시거든요
네. 대략 몇 시간이나 이용하실 예정이세요?	이용하시다가 배고프시면 배달음식 주문 가능하세요
한 시간에 얼마인가요?	시간당 오만 원입니다
음료수 먼저 가져갈게요	음료는 먼저 계산해 주세요
발레파킹 되나요?	직접 주차 하셔야 해요
다른 당구대로 옮겨도 되나요?	물론입니다
여기 배달되나요?	가능합니다
음료수는 서비스로 나오나요?	준비해드릴게요
예약하신 분이신가요?	1박에 3만 원 주시면 돼요
큰 방 말고 독채도 있나요?	독채는 없고 큰 방으로 준비해드리겠습니다
공항이요?	공항 맞아요
취사 금지인가요?	저희 호텔은 취사 금지예요
체크인 시간은 몇 시에요?	체크인은 오후 세 시부터, 체크아웃은 오전 열한 시에요
체크인하려고 하는데요?	김철수 고객님 체크인 해드릴게요
몇 시까지 영업하나요?	12시입니다
캠핑에서 생긴 쓰레기는 어떻게 처리하나요?	텐트 구역을 배정받으시면 봉투를 드려요
비상구는 어디에 있나요?	비상구는 뒤쪽 보시면 비상구 표시 되어 있어요
PC방 영업시간이 어떻게 되십니까?	24시간 영업합니다
마트 거리가 도보로 5분 거리인가요?	차로 5분 거리에요
2시간 이용하겠습니다	2시간 등록해드리겠습니다
바비큐 고기도 파시나요?	고기는 따로 준비해주셔야 합니다
파티룸 두 개던데 두 개다 보고 결정할 수 있나요?	A 방은 예약이 되어있어서 B 방만 가능해요
네, 두 개 드릴까요?	법적으로 혼숙은 안 돼요
매점은 몇 시까지 하나요?	밤 10시까지 해요
퇴실은 몇 시인가요?	퇴실시간은 낮 12시에요
청소년들은 몇 시까지 이용이 가능한가요?	청소년은 오후 10시까지 이용 가능합니다
공항에서 택시를 타고 가면 얼마쯤 나오나요?	공항까지 택시비는 삼만오천원 정도 나올 거에요
주문한 음료는 가져다주시나요?	제가 자리로 가져다드립니다
네, 어떤 방을 원하시나요?	현재 두 개 남아있어요
여기 헤드셋이 없는데 헤드셋 하나 주실래요?	가져다드릴게요
음료도 있나요?	탄산음료랑 생수 있습니다
키즈클럽이랑 수영장은 다 이용할 수 있네요?	키즈클럽, 수영장은 가능하세요
주차할 수 있는 시설같은 건 있어요?	주차공간은 따로 없습니다
청소년 5시간 충전해주세요	여기 자동이라서 기계가서 직접 하셔야 해요
몇 시간 이용하면 되나요?	이용시간은 두 시간이에요
성인은 10000원이고 초등학생은 6000원인데, 지금 티켓을 구매하실 건가요?	아니요, 내일 오전에 이용할 건데요
큰 룸은 얼마에요?	큰 방은 32만원이세요
주위에 관광지 볼만한 거 있나요?	추억의 달동네, 성테마파크 러브캐슬, 불국사, 보문단지 근방에 다 있어요
공휴일에도 영업하시구요?	휴일 없이 영업하고 있어요
회원가입을 안 해도 이용을 할 수 있는 거죠?	회원가입을 안 해도 이용할 수 있습니다
조금 시끄러워서 자리를 옮기고 싶은데요	도와드리겠습니다
대실 가격이 어떻게 되나요?	대실은 기본 두 시간에 2만 원이에요
저희 3명 캠핑장은 처음이라서 이용안내 좀 해주실래요?	처음이시라면 1박 2일 코스를 추천드려요
요금 충전은 어디서 하나요?	입구 앞쪽에 기계에 하시면 됩니다
이번 주말 트윈룸으로 하나 예약해주실래요?	예약해 드릴게요
바비큐는 저희가 해먹을 수 있어요?	바비큐는 고기는 준비해 오시고 이용료 3만원에 발코니에서 구워 먹으면 되세요
내일 퇴실은 몇 시인가요?	11시까지에요
음료수는 뭐 뭐 있어요?	드시고 싶은 음료수 있으면 서비스로 드릴게요
체크아웃 도와주실래요?	여기 계산서 드릴게요
네 큐대는 저기 있는 것을 사용하면 됩니까?	편하신 대로 이용하시면 됩니다
더 필요하신 건 없으신가요?	없습니다
바비큐 다 하고 치우는 건 어떻게 하나요?	음식물 쓰레기와 기타 쓰레기 분리하셔서 캠핑장 앞에 분리수거하시면 돼요
집게 등 다른 기구들은 어디에 있나요?	매점에 있어요
청소년들은 몇 시까지 이용가능한가요?	오후 10시까지 이용 가능합니다
음료는 어떤 거 있나요?	탄산음료랑 커피 아니면 식혜도 있어요
일행분은 성인이신가요?	죄송하지만 일행분이 어려 보이셔서 신분증 검사 좀 할게요
성함이 어떻게 되시죠?	하재현이요
가격은 얼마에요?	숙박 12만 원이에요
여기 피씨방 영업시간이 어떻게 되나요?	여기는 영업시간이 24시간입니다
오늘 당장 묵을 방이 있나요?	디럭스룸이랑 스위트룸 1개씩 남아있어요
몇 명까지 동시에 숙박이 가능한가요?	9명까지 동시 숙박이 가능해요
몇 분이신가요?	성인 두 명이요
커플석은 구비되어 있나요?	저희 커플석은 따로 없어요
예약이라든지 그런 거는 다 가능한가요?	예약같은 거는 가능하세요
일회용 세면도구가 있나요?	세면도구는 직접 가져오셔야 해요
4명 자리 좀 주세요	지금 나가신 곳 정리해서 알려드릴게요
바비큐 장작은 별도로 추가 해야 하나요?	장작도 함께 제공됩니다
주변에 가까운 마트는 어디에 있나요?	왼쪽으로 1km쯤 가면 돼요
결제할 때 카카오페이가 가능한가요?	저희는 카카오페이 안 돼요
숙박 7일 예약 되나요?	70만 원이에요
수건이 부족한데 더 가져다주실 수 있나요?	필요한 만큼 더 준비해드릴게요
그러면 저희 예약 가능한가요?	가능하세요
거기 남녀 공용 아닌가요?	그렇긴 하지만 키가 있어야 들어갈 수 있어요
저희 조금 고민해보고 다시 전화 드리겠습니다, 수고하세요	전화 꼭 주세요
제휴 할인 카드 있나요?	제휴 할인은 없어요
바비큐 세팅도 같이 할 수 있을까요?	바비큐도 이용 가능해요
일시불로 부탁드립니다	여기 사인해주세요
카카오페이나 삼성페이도 가능하세요?	카카오페이나 삼성페이도 가능합니다
성인 2명 하고 어린이 2명인데 예약하려고요?	성인 2명, 어린이 2명 예약 가능해요
네, 디럭스룸 4인 이용하시는 거 맞으세요?	거기에 조식 뷔페까지 같이 결제했어요
시간당 얼마예요?	시간당은 아니고 10분당 2000원입니다
음료 서비스도 있죠?	물론이죠
룸에서 룸서비스가 가능한가요?	룸서비스 가능해요
따로 주의할 사항 있나요?	테이블에 걸 터 앉거나 테이블 위에 마실 거나 먹는 것 올려주시지 않으면 됩니다
다른 방으로 업그레이드 해주세요	여기 바꾸신 방 키 드릴게요
풀장은 어린이도 사용 가능한가요?	사용 가능해요
이 부근에 맛 집이 있나요?	유명한 국밥집이랑 냉면집이 있어요
4명 얼마인가요?	2명 기본 20만 원에 인당 추가 3만 원이에요
치약 칫솔은 따로 주시나요?	칫솔, 치약은 방 안에 구비되어 있어요
체크인 시간이랑 체크아웃 시간이 몇 시부터 몇 시인가요?	체크인 시간은 오후 세 시부터이고 다음 날 열한 시까지가 체크아웃 시간이에요
중국집 배달시킬 수 있나요	당골 집 번호 알려드릴게요
몇 시 정도에 퇴실할 계획이세요?	가능하세요. 대신 추가 요금이 붙어요
좁아도 괜찮으니 한 방에 5명이 자도 될까요?	대신 추가 요금이 발생해요
오늘 온돌방으로 예약 되나요?	302호로 안내해 드리겠습니다
며칠 전에 예약해야 자리가 있는 건가요?	일주일 전에는 예약해주셔야 해요
캠프파이어 서비스도 추가하실 건 가요?	여기서 파는데 보통은 사 오세요
예약했는데요?	김철수 님 예약 확인되었어요
욕실용품은 다 구비되어 있나요?	욕실용품 구비되어 있어요
영업시간 언제까진가요?	11시까지입니다
날짜는 언제로 예약하실 건가요?	다음 주 금요일부터 일요일까지요
여기 피시방에서 할인 이벤트 같은 것은 안 하나요?	고등학생까지는 10시간 이용 시 1시간 무료로 해줘요
빈 테이블 있나요?	저쪽 테이블 비어있습니다
제 짐을 맡겨도 될까요?	지하 1층에 임시 보관함이 구비되어있어요
십만 원, 할인된 가격이죠?	할인된 금액이라 십만원이에요
컴퓨터 사양은 베틀그라운드라든지 이런 거는 다 돌아갈 정도 되나요?	웬만한 게임은 다 됩니다
대실인데 왜 이렇게 비싸요?	성수기 요금이 적용돼서 그래요
주차장은 있나요?	주차장 있어요
여기 영업시간이 어떻게 되나요?	영업시간은 24시간입니다
조식 포함인가요?	포함 가격입니다
혹시 구미 시민이시거나, 할인 혜택이 가능하신가요?	그건 아닌데, 대구인데
바비큐 추가 할 때 인원 수에 따라 가격이 추가되나요?	가격은 인원수 상관없어요
그럼 1시간에는 얼마인가요?	1500원입니다
조금 있다가 다시 전화드릴게요	전화 주세요
이번 주 일요일에 가족이 머물 건데 방이 혹시 있나요?	물론 방이 많이 있어요
캐라반 하루 사용료가 얼마예요?	주중에는 육만원이고 주말에는 팔만원이에요
일박 이일로 저희가 예약을 하면 가격은 얼마 정도인가요?	사월 삼일 하시면 최저가 요금으로 이십삼만 원이에요
한 룸당 최대 인원이 4명이에요	추가인 원당 만원 있으세요
청소는 매일 해주나요?	청소는 매일 해드릴 수 있어요
아무 자리에 가서 하면 되나요?	알겠습니다
비상구는 어느 쪽에 있어요?	비상구는 저쪽이랑 이쪽에 있습니다
욕실용품은 어떤 게 제공되나요?	칫솔 치약 빼고는 다 제공되요
계산 좀 해주실래요?	2만 원입니다
와이파이는 가능한가요?	저희 호텔, 와이파이 가능해요
남는 방 있나요?	있어요
네, 카드로 하실 건가요?	영수증은 버려주세요
혹시 예약은 가능 한가요?	약은 안 됩니다
혹시 비상구는 어느 쪽에 있나요?	비상구는 여기랑 저쪽 히터 옆에 있습니다
화장실 어디 있어요?	나가서 오른쪽이에요
주말에 5인 가족 2박 투숙하려고 하는데 트윈베드 룸 있나요?	트윈 베드룸으로 주말에 방 있어요
커플석도 있나요?	커플석은 따로 없습니다
혼자서는 대실이 불가능한가요?	혼자서도 대실하실 수 있어요
죄송합니다, 날짜 다시 말씀해주시겠어요?	사월 육일 일박 이일이요
제휴 할인 카드 있나요?	저희 제휴나 할인 카드 없고 일반 카드만 받아요
결제할 때 제휴 할인 카드가 있나요?	제휴 할인 카드는 없어요
침대방도 가격은 똑같습니까?	침대방이 이층이고 넓어서 좀 비싸요
방 금액은?	금액은 조식, 온천 포함해서 사인 기준 십이만 육천 원이에요
몇 분이신가요?	죄송하지만 옆방으로는 예약이 어려울 것 같아요
음식 배달해서 먹어도 되나요?	배달해 드셔도 돼요
독채펜션인가요?	독채입니다
언제인지에 따라 달라요. 언제 숙박하실 건가요?	오늘부터 3일이요
몇 분이세요?	저희 성인 두 명이에요
프린트 사용해야 되는데 프린트 있나요?	있습니다
추가 인원에 엑스트라 베드 놔 주시나요?	따로 침구만 더 챙겨 드려요
저희가 온돌방도 있고 침대방도 있는데, 어떤 거로 하시겠어요?	온돌방 가격 알고 싶네요
무인 결제기 어디 있죠?	이 앞에도 있고 군데군데 설치되어있습니다
언제부터 묵으실 계획이세요?	4월 초부터 한달 정도요
아이가 몇 살 정도인가요?	아이들 나이는 5살, 7살이요
숙박 가능한가요?	숙박 가능하세요
상의해보고 전화드릴게요, 수고하세요	전화주세요, 감사합니다
소금이람 참기름이랑 고추장 부탁드려도 될까요?	같이 준비해드릴게요
저녁시간에 바비큐 불 좀 준비해주세요	미리 연락 한 번 주시면 바로 해드릴게요
세면도구 살 수 있어요?	세면도구는 천 원이에요
8월 중에 예약 가능한 날이 언제인가요?	8월 말에는 가능해요
선불만 가능한가요?	후불은 안되고 선불만 가능하세요
저 이 호텔 회원인데 더 높은 층으로 주시겠어요?	17층으로 업그레이드해드릴게요
근처에 고기나 식사할 수 있는 곳 있을까요?	안내해 드릴게요
바비큐는 인당 얼마예요?	만 오천 원이에요
야외에서 바비큐를 할 수 있을까요?	가능해요
외부음식도 시켜 먹을 수 있어요?	중국집만 가능합니다
시간에 얼마예요?	세 분이시면 2만 원입니다
음료는 뭘로 하시겠어요?	음료수랑 공 준비해드리겠습니다
오션뷰로 드릴까요?	오션뷰로 주세요
이용요금은 10분에 얼마입니까?	이 동네는 전부 1300원이에요
4인 기준으로 좀 넓은 방을 원하는데, 있나요?	4인 쓰시기에 괜찮은 방 있어요
아이들이 놀 수 있는 수영장이 있나요?	20명이 이용할 수 있는 수영장이 있어요
당구장 예약은 가능한가요?	약도 가능하신데 당일은 예약이 힘들 수 있으세요
카카오페이 결제가 가능한가요?	바코드 결제만 아니면 삼성페이, 무슨 페이 다 가능하세요
저 3번 자리인데 30분 추가해주세요	30분 추가되었습니다
스파방인 경우에는 얼마에요?	제트스파를 이용한다면 주말에 십사만원인데요
몇 분이서 머무르시죠?	2명이요
체크인은 몇 시까지인가요?	자정까지 오시면 되고 늦으실 경우에는 호텔 측으로 연락해주세요
지금 바로 체크인할 수 있나요?	체크인 가능해요
카카오페이 되나요?	죄송하지만, 아직 저희 매장은 안됩니다
영수증 필요하신가요?	방 열쇠 드릴게요
더 필요한 건 없으세요?	숯불이랑 같이 가져다드릴게요
성함 알려주세요	2박 3일로 예약하셨네요
체크인 시간은 몇 시부터예요?	체크인은 오후 2시부터 들어오실 수 있고, 체크아웃은 11시까지 하시면 돼요
예약했는데 어디로 가면 되나요?	방 키 가지고 저를 따라오세요
혹시 구미 시민이시거나, 할인 혜택이 가능하신가요?	4인실 정상가는 금요일이나 주말같은 경우 성수기 기준으로 1박에 칠만원입니다
당구장 예약이라든지 이런 거도 가능한가요?	약은 선착순으로 받고 있어요
금액은 얼마인가요?	흑백일 경우 A4용지 1장당 100원입니다
출력물 찾으러 왔는데요	10장 하셔서 총 500원입니다
예약하신 분 성함이 어떻게 되는지 알 수 있을까요?	김성현으로 예약했습니다
방 2개가 층이 다른가요?	같은 층에 있어요
체크인할 수 있을까요?	305호실입니다
너무 많이 가지고 계신다면 조금 더 큰 방을 드릴까요?	그건 너무 크니까 8인실로 주세요
샴푸나 린스는 구비가 되어있나요?	칫솔은 가져오셔야 하는데 샴푸, 린스, 바디클렌징 다 있어요
주민등록증 없는데 운전면허증 되나요	운전면허증도 됩니다
배달 가능한 중국집 전화번호 부탁드려요	계산대 앞에 배달 가능한 전화번호 있으니 편하신 곳으로 이용하시면 됩니다
여기 삼구 공으로 바꿔주세요	죄송하지만 현재 남아있는 삼구 공이 없네요
13층으로 부탁 드려도 될까요?	디너 뷔페와 조식 이용하려고 합니다
연박인데 할인 안 될까요?	선입금하시면 2만 원 할인해 드릴게요
기다리는 동안 담배 피우고 싶은데 흡연실은 어디에요?	비상구라고 적힌 문 열고 나가시면 됩니다
자차로 가면 발레파킹은 해주시나요?	발레파킹 시스템은 별도로 없어서 고객님이 직접 주차해주셔야 해요
혹시 거기 한 달씩 숙박도 되나요?	한 달 숙박해도 가격은 똑같아요
혹시 여기 와이파이는 설치가 되어있나요?	와이파이가 설치되어 있습니다
체크아웃 시간을 연장할 수 있나요?	오만 원 더 결제하시면 돼요
봉사료는 얼마인가요?	저희는 부가가치세와 봉사료 포함된 가격으로 판매를 하고 있기 때문에 따로 발생하지는 않아요
오늘 방 있나요?	있어요
바비큐 신청은 어떻게 해야 하죠?	비용은 만 원이고, 시간 말씀해주시면 돼요
스위트룸 1박에 얼마인가요?	20만 원이에요
선불이에요?	선불입니다
시간당 얼마인가요?	만 원입니다
여기 계란 들어간 라면 하나 주세요	잠시만요
네 혹시 짜장면 배달 가능한가요?	저한테 말씀하시면 주문해 드립니다
체크아웃 시간은요?	뒷날 열한 시까지예요
취사도구도 필요하신가요?	갖다 주세요
그럼 짜파게티 컵라면이랑 콜라 하나 주세요	알겠습니다 자리에서 기다리면 가져다드리겠습니다
자리 있나요?	원하시는 곳에 앉으시면 됩니다
회원이 아닌 일반인들은 예약이 불가한가요?	어린이날은 추첨이라 일반인들은 예약이 안 되고 당일에 취소하신 분들이 있으면 예약이 가능하세요
특실로 2박 3일 예약해주실래요?	예약 되었어요
혹시 비상구는 어느 쪽에 있나요?	비상구는 여기 하나랑 저쪽이랑 해서 두 개 있습니다
그리고 콜라도 하나 같이요	알겠습니다
경주 보문단지 안에 있는 펜션인데요?	여섯 분 입실 가능하신 펜션이 '가이드 펜션'이라고 경주에 있어요
성함이 어떻게 되세요?	약 확인되셨고, 208호 키 드릴게요
사월 십삼일 일박 이일로 예약이 가능한가요?	저희 홈페이지에 들어가면 지금 예약이 가능하실 거예요
내일 체크아웃은 몇 시인가요?	체크아웃은 12시까지에요
여기서 걸어가도 당구장 까지 얼마 안 되죠?	이쪽 큰길로 나가셔서 사거리에서 신호등 건너서 조금만 가시면 돼요
3구 치려고 하는데 대 다이 있어요?	3구는 되지만 대 다이는 없습니다
혹시 예약같은 거도 가능할까요?	예약은 안 됩니다
사월 이십 며칠 일박 이일로 대인 이인이 이용하려고 하거든요	성인 두 분이면 열평짜리 온돌 룸, 침대 룸이 예약이 가능하세요
비상구는 혹시 있나요?	흡연실 오른쪽에 있어요
매점에서 쓰레기 봉투도 팔죠?	팔긴 한데 50리터 100리터만 있어요
문상으로 충전할 수 있나요?	기계에서 직접 충전하시면 됩니다
조식 이용하는 시간은 몇 시부터 몇 시까지인가요?	조식은 아침 여덟시부터 열시까지 이용하시면 돼요
화로 대여해주시나요?	대여비 2만 원이에요
바비큐장 이용 가능한가요?	가능해요
요금은 한 시간에 얼마정도 하나요?	한 시간에 800원이에요
프린트만 하려고 하는데 PC 사용료 내야 하나요?	프린트만 하실 경우에도 1시간 이용 요금 내셔야 합니다
사월 십삼일 말씀이신가요?	사월 십삼일 맞아요
4구 주세요	편한 자리로 가세요
방은 몇 개 드릴까요?	여기 203호 204호 키 받아 가세요
비품 같은 건 요청하면 주나요?	드려요
발급하면 바로 사용 가능한가요?	바로 사용 가능해요
더블룸은 하루에 얼마인가요?	2인 기준 1박에 10만 원이에요
룸 내에서 배달 음식을 시켜서 먹어도 되나요?	배달은 시켜 드셔도 돼요
네, 몇 분이세요?	6명이요
5월 3일부터 5일까지 숙박 예약이 가능한가요?	예약 가능하세요
예약할 수 있는 방이 몇 개 있나요?	객실 2개 있어요
당구 큐대는 몇 개 구비되어 있나요?	모든 사람이 공용으로 사용할 수 있는 건 40개 있습니다
네, 고객님 예약번호랑 여권 부탁드릴게요	방이 몇 층인지 알 수 있을까요?
밤에는 몇 시까지 이용 가능한가요?	저희 피시방은 24시간 운영하고 있습니다
아드님이 당구를 한 번도 쳐본 적은 없죠?	아니요, 취미로는 쳤죠. 그런데 대회는 안 나가봤죠
네, 날짜는 어떻게 예약하시려고 하세요?	금, 토, 일이요
5월 중에 2박 3일간하고 싶은데 언제 방이 비어있나요?	현재 5월 5일에서 7일 2박 3일 가능해요
공휴일에도 영업하나요?	아직까지는 휴일 없이 하고 있어요
빈자리 있나요?	창가 쪽 마음에 드시는 자리로 가시면 됩니다
캠핑 자리 있나요?	한 곳 남았네요
복층 구조가 어떻게 생겼나요?	이층에 베드가 2개 있고 거실로 되어있어요
네 자리 생기면 알려주세요	즐거운 시간 되세요
배달 음식 시켜도 되나요?	가능하세요
조식은 하나요?	조식은 이용 손님들이 많이 없어서 이제는 안 하고 있어요
회원가입을 해야만 사용이 가능한가요?	비회원도 이용 가능하세요
물은 잘 나오나요?	물은 잘 나와요
계좌번호 알려주실래요?	캠핑장 공식 사이트 들어가신 후에 문의 코너 들어가시면 제일 밑에 계좌번호 있어요
여섯 명 자리가 남아있나요?	이쪽 자리 금방 치워드리겠습니다
침구 교체는요?	침구 교체도 요청하시면 가능해요
와이파이는 설치가 되어있나요?	와이파이는 설치되어 있습니다
대회 나가실려고요?	어릴 때부터 쳤어요
성함이 어떻게 되세요?	김진섭입니다
어디 사용하면 될까요?	편하신 곳 사용하시면 됩니다
방은 바다쪽 뷰로 드릴까요?	바다쪽으로 주세요
수영장은 따로 운영 시간이 있나요?	수영장은 아침 여덟 시부터 밤 열한 시까지이고 한 시부터 두 시까지 브레이크 타임이 있어요
카카오페이 결제는 가능한가요?	카카오페이 결제는 안 하고 있어요
언제 자리 나와요?	10분 뒤면 한자리 빌 예정입니다
남자 3명이 묶을만한 방 있나요?	현재 a방은 2일 동안 b방은 3일 동안 예약이 비어있어요
회원가입 혜택 있나요?	포인트 적립해서 이용 가능하세요
지금 수리공을 보내드리려 하는데 괜찮으세요?	지금 올라갈게요
회원이 저렴한 편이죠?	1시간에 800원이에요
여기 마우스가 작동이 안 돼요	제가 봐드릴게요
네, 당구에 관심이 많으신가 보네요, 아드님이?	맞아요
식당은 몇 층인가요?	식당은 2층이에요
체크아웃은 몇 시에요?	한시나 두시까지 계셔도 괜찮아요
주차할 수 있는 시섵같은 거는 있나요?	주차장은 건물 주차장 사용하시면 됩니다
체크아웃 후 짐 보관해주시나요?	안내 데스크에 맡기시면 짐을 보관해 드려요
PC방 그래픽카드 사양은 어느정도 되나요?	그래픽카드 사양은 배그 돌아가는 정도라고 생각하시면 돼요
체크인 시간은 몇 시부터, 체크아웃 시간은 몇 시까지인가요?	체크인 시간은 네 시부터고 체크아웃 시간은 다음 날 오전 열두 시까지 하시면 돼요
화장실 어디에요?	나가서 오른쪽이요
현금으로 낼게요	현금 결제 도와드릴게요
입실은 몇시에 해요?	입실은 오후 세 시부터 퇴실은 다음 날 오전 열두 시까지요
3월 27일에 쓰려고 하는데, 어떻게 예약하나요?	그 시간에는 펜션 1호 사용 가능해요
조식 메뉴를 알 수 있을까요?	조식으로는 라면과 토스트 시리얼이 준비되어 있어요
침대방이에요? 아니면 온돌이에요?	밑에는 온돌이고 위에 침대방도 바닥이 따뜻해요
늦게 체크아웃 해도 되나요?	한 시까지 나가주시면 돼요
계산은 혹시 카드도 가능한가요?	카드는 안 됩니다
정액권 끊으면 할인되나요?	10퍼센트 할인됩니다
가격은 어떤 게 괜찮을까요?	토요일의 패밀리 트윈은 삼십구만 육천 원, 디럭스 트윈은 삼십사만 천 원이에요
오늘 날짜로 예약하는 게 맞으신가요?	오늘 바로 묵을 예정입니다
지금 다른 사람들 중에 대기하고 있는 인원이 있나요?	약 3팀 정도가 대기하고 계십니다
계산은 현금만 되나요?	카드로도 결제가 가능하십니다
혹시 당구를 치다가 다른 손님이 가시면 포켓볼로 옮겨도 되나요?	그런데 게임비는 따로 지불하셔야 합니다
현금 결제하면 더 싸나요?	현금이나 카드나 가격은 같아요
시내까지 도보로 갈 수 있어요?	차로 이동해야 해요
조금만 고민해보고 다시 전화드릴게요	큰 방 하실 거면 주말에 금방 빠지니까 조금 서두르셔야 해요
숙박이신가요, 대실이신가요?	대실이요
청소같은건 다 해주시고예?	보고 며칠에 한 번 씩 해요
여기서 짜장면 시켜 먹을 수 있나요?	가능하세요
와이파이는 되나요?	와이파이는 돼요
저 여기 비밀번호 좀 찾을 수 있을가요?	아이디는 성함 그대로 하시면되고 비밀번호 에이하고 일부터끝까지로 바꿔드릴께요
당구 치러 왔는데요	빈자리 이용하시면 됩니다
바비큐 이용은 비용 없다는 거죠?	바비큐는 무료로 해주고 노래방 시설도 있어요
몇 시까지 룸서비스 가능한가요?	24시간 가능해요
몇 시간씩 할 수 있나요?	선불로 시간 단위로 끊으셔도 되고 후불제로 사용하셔도 됩니다
요금은 10분에 얼마인가요?	10분에 1400원이에요
여기 5시간 충전해주세요	충전해드렸습니다
몇 명이신가요?	사용하실 온돌방 있어요
여기 당구도 알려주나요?	전 아르바이트생이라서 따로 알려드리진 못해요
그 방은 침대가 몇 개인가요?	더블베드 2개가 놓여 있어요
음료 한 잔씩 드리는데 뭘로 드릴까요?	환타로 주세요
분리수거는 어디에서 하나요?	관리사무소 옆 분리수거장을 이용해주세요
지금 3자리 붙어있는 자리는 없나요?	복도 쪽에 사용자분 5분 남으셨어요
옆에 사람들은 피던데요?	제가 가서 안 된다고 말씀드리겠습니다
혹시 주차할 수 있는 공간은 있나요?	주차할 데는 없습니다
앱 카드로 결제되나요?	페이코와 삼성페이만 결제 가능해요
체크인 시간 전에 가도 되나요?	체크인 시간에 맞춰와주세요
조식은?	저희는 조식이 없어요
친구들이랑 의논해서 다시 전화를 드릴게요	의논해 보시고 전화를 주세요
회원 번호 알려주시겠어요?	회원 번호는 1234567입니다
커피숍은 있나요?	이층에 커피숍은 있어요
3월 23일에 2명씩 따로 머물 수 있는 방 있나요?	그 날은 2명이 머물 수 있는 한 곳 밖에 안 남았네요
이걸로 예약해 주실래요?	알겠어요.
두 명인데 바로 게임 가능한가요?	10분 정도 대기해주셔야 할 것 같습니다
몇 분이 서 주무실 건가요?	결제 먼저 해드릴게요
먼저 1명만 결제하고 나중에 인원 추가되면 말씀드려도 되지요?	그렇게 하셔도 돼요
5시간 할게요	시간 넣어둘게요
야놀자'랑 전화로 예약하는 거랑 혜택이 다르고 그렇습니까?	여행 사이트에서 제공되는 요금은 자체적으로 기획한 금액이라 저희가 안내해 드리는 요금과 다를 수 있어요. 비교해보시고 가장 좋은 쪽으로 진행해주시면 돼요
그럼 의자에 앉아서 기다려도 되나요?	여기 앉으세요
1시간에 얼마인가요?	1시간에 1000원입니다
가격은 얼마예요?	흑백은 장당 100원이에요
예약을 위해 성함과 전화번호 알려주세요	6시 30분쯤에 예약 확인문자 드릴게요
생수는 더 달라고 하면 받을 수는 있나요?	생수는 요구하는 대로 드려요
네 어떤 걸로 드릴까요?	신라면 하나랑 콜라 하나 주세요
알겠습니다, 일단 알아보고 전화드릴게요	전화 주세요
몇 번 객실이세요?	203호입니다
회원가입을 안 해도 이용이 가능할까요?	비회원도 이용 가능합니다
커플석 같은거는 있나요?	커플석은 따로 없습니다
아이 2명과 성인 2명인데 1박 가격은 어떻게 되나요?	1박에 8만 원이에요
확인되었고 5명 맞으시지요?	5명 맞습니다
투 베드룸으로 예약 되나요?	현재 투 베드룸은 만실이라 킹 베드룸으로 씨뷰로 업그레이드 해드릴게요
바비큐 숯불 이용해야 하는데 그 비용은 얼마쯤?	숯불 이용은 2만원이고 고기도 구워 드려요
회원가입을 어떻게 해야하나요?	개인정보 입력을 하시면 됩니다
김빛나로 예약했는데, 확인 부탁드려도 될까요?	고객님 위치 확인하시고 가시면 됩니다
그럼 아직 짜장면은 괜찮나요?	짜장면은 괜찮습니다
회원가입하실 건가요?	간단하네요
몇 분이 투숙하시나요?	한 명이에요
혹시 흡연 가능한가요?	당구장 안에서는 흡연이 안되고 따로 흡연실이 마련되어 있습니다
비회원 가격은 또 따로 있어요?	비회원은 900원입니다
네, 예약해드릴까요?	감사합니다
간식 가격도 올랐네요	요새 물가가 다 올라서 어쩔 수 없네요
자리 옮기고 싶으면 어떻게 해야 하나요?	말씀하고 옮기시면 됩니다
어디서 배달시켜먹으면 되나요?	중국집에서 많이 시켜 먹어요
짜장면 배달되나요?	됩니다
아침 식사비용을 지불해야 하나요?	그냥 저희가 해 드려요
당구장 안에서 음식 배달시킬 수 있나요?	가능합니다
오늘 숙박 가능한가요?	지금 패밀리룸은 남은 방이 없지만, 온돌이나 더블베드는 있어요
카드로 혹시 지불 가능할까요?	정산 기계에서 카드로 하시면 됩니다
음식 시켜도 될까요?	방에서 음식 시키셔도 돼요
방이 그렇게 작지는 않죠?	방이 아주 좁지 않아요
비회원도 이용할 수 있어요?	비회원도 이용할 수 있습니다
얼마정도 배우면은 대회 좀 나가고 할까요?	한 육 개월 정도요 연습하는 만큼 느니까 연습량이 중요하죠. 배우는 것보다 본인이 얼마나 열심히 하느냐가 더 중요해요
예약을 위해 성함과 전화번호 알려주세요	이름은 가나다이고 전화번호는 01012345678입니다
오션뷰와 시티뷰 중 어느 걸로 하시겠습니까?	오션뷰는 추가 비용 3만 원 추가돼요
포켓볼 한 시간에 얼마에요?	한 시간에 2500원입니다
업그레이드하면 추가 비용이 있나요?	이건 서비스여서 추가 비용은 없어요
계좌이체 가능한가요?	계좌이체 관련 문자로 알려드릴게요
흡연부스 있나요?	있습니다
청소년들은 몇 시까지 이용이 가능합니까?	청소년 손님은 받지 않아요
지금은 선생님께서 다른 분 레슨 가르치고 계세요?	지금은 경기 중이시고 끝나면 말씀 드릴 거에요
시간 추가는 가능한가요?	시간 추가 가능하시고요, 시간당 만 원이에요
이번 주요?	이번 주 금, 토, 일이요
세면도구는 추가 비용인가요?	세면도구는 무료 제공이에요
오늘 4인실 방 있나요?	4인실 방은 없어요
지금 pc 자리 있나요?	바로 사용할게요
인원이 어떻게 되시죠?	2명이 이용할 거예요
근처에 관광지나 볼만한 곳이 있나요?	경주는 관광지는 많은데 무조건 차를 가지고 이동하셔야 해요
펜션 방 있나요?	마침 딱 하나 남았어요
수영장 바로 들어가도 되죠?	편하게 쓰세요
2만 5천 원은 카드로 해주시고 5천 원은 현금 드릴게요	결제 되셨어요. 방으로 가시면 돼요
예약하신 분 성함 좀 알려주실래요?	지금 방이 두 개 남아 있어요
카드 결제되나요?	아뇨 이벤트 중이라 현금결제만 가능합니다
네, 어떤 방 찾으세요?	5명이서 잘 방이요
내일 숙박하려고 하는데 요금은 얼마나 되죠?	평일은 1박에 6만 원이에요
사장님, 여기 4만2천원이 2명인데 성인용인가요?	어른 2명에 4만2천원이에요
중국음식 배달됩니까?	배달됩니다
하루에 얼마인가요?	하루 숙박에 5만 원이에요
삼월 이십육일 예약이 가능한가요?	삼월 이십육일 예약 가능하세요
이 방은 온돌방인데 괜찮으세요?	온돌방이 좋습니다
1박에 얼마예요?	1박에 10만 원이에요
2박 3일 머물려고요	큰 방 2박이면 20만 원이에요
혹시 회원가입을 해야지만 사용이 가능한가요?	비회원도 사용 가능합니다
음료도 콜라로 주문해 주세요	알겠습니다
당구장 영업시간이 어떻게 되나요?	11시까지 입니다
몇 번 객실이세요?	잠시만요, 확인해볼게요
바비큐 장을 저녁 8시쯤 사용해도 될까요?	시간 맞춰서 숯불 준비 해놓을게요
현금으로만 가능한가요?	현금만 받고 있어요
한 시간에 얼마죠?	시간당 4000원입니다
수건이나 샴푸 등도 다 비치되어 있나요?	수건과 샴푸는 비치되어 있고, 추가로 세면도구가 필요하시면 말씀해 주세요
각각 가격이 얼만데요?	흑백은 장당 1000원이고 컬러는 장당 1500원이요
숯은 만 원인데 예약해드릴까요?	약해주세요
강아지와 동반 가능한가요?	가능해요
네, 성함과 휴대폰 뒷자리 알려주시겠어요?	000이고 뒤 번호는 1234입니다
성인 세 분이신 거죠?	성인 세 명이에요
대회 나가실려고요?	가게 한 번 놀러 오라고 하세요
계산은 카드로도 가능한가요?	가능하신데 신한카드는 안받고 있어요
혹시 비상구는 어디에 있나요?	비상구는 출입구 나가시면 계단쪽에 있어요
오늘 방 있나요?	스위트룸와 디럭스룸이 있어요
대실은 얼마인가요?	대실은 기본 30000원이에요
십삼일 쿠폰 가지고 계신 게 있으신가요?	아니요, 쿠폰은 없어요
30분만 이용하고 싶은데요	최소 단위가 1시간입니다
외부 음식 반입도 가능한가요?	여기서 파는 음식만 가능합니다
음식은 갖다 주시는 건가요?	음식은 갖다 드립니다
여기 예약은 가능한가요?	약도 가능하세요
체크인 시간은 몇 시인가요?	오후 2시부터 체크인 가능해요
몇 분이세요?	더블룸으로 안내해 드릴게요
조식은 몇 시부터인가요?	오전 6시부터에요
6명이 조식하면 얼마에요?	조식하시게 되면 1인당 만9천원이 추가돼요
애들이 놀 키즈시설 있나요?	키즈시설은 없어요
청소년들은 혹시 몇 시 까지 사용이 가능합니까?	아직 정해진 것은 없어요
체크아웃은? 3일 후에는 12시까지 나와야하죠?	1시나 2시까지에는 나와야해요
오늘 숙박하려는데 성인 3명도 가능한가요?	저희는 2인실밖에 없어서 세 분이면 방을 두 개 쓰셔야 해요
그럼 그냥 비회원 금액으로 결제해주세요	31번 자리로 가시면 됩니다
어떤 맥주로 드릴까요?	클라우드로 주세요
방은 따뜻한가요?	방은 너무 더워요
포켓칠 수 있어요?	근데 지금 자리가 없어요
같은 층이 아닌데 괜찮으세요?	상관없어요
여기 캠프파이어 장소가 어디인가요?	중앙 화장실 옆에 있어요
근처 아침 식사할 만한 데는 있어요?	앞에 청국장집도 있고 건너편에 김밥집도 있어요
방에 수건이 몇 장 있나요?	총 4장 있습니다
네 그럼 120분 이용할게요	3천 원입니다
일박에 숙박료가 얼마죠?	제일 기본인 스탠더드 더블룸은 평일에 하시면 십일만 팔천 원이에요
지금 방 있나요?	방 있어요
아침은 주나요?	저희는 조식은 안 드려요
지금 1인 객실 있나요?	그렇게 예약해드릴게요
토요일, 주말 원하시는 거죠?	토요일 맞아요
선불로 시간 충전 3시간 하겠습니다	회원제 할인으로 3000원 되겠습니다
사구는 바로 칠 수 있나요?	사구도 조금 기다리셔야 해요
편의시설은 어떤 게 있나요?	키즈카페는 따로 구비되어 있지는 않아요
방은 있는데 몇 분이세요?	애들이랑 네 명인데 가족이 잘 거예요
인근에 가장 가까운 마트가 어디입니까	차량으로 5분 거리에 XX 마트가 있어요
여기 피시방 영업시간이 혹시 어떻게 되나요?	저희 피씨방은 24시간 영업합니다
일회용품 필요하신가요?	주세요
2시간 쳤는데 서비스 시간 조금 주실 수 있나요?	그럼 한 게임 더 치세요
몇 명이신가요?	아직 정확히는 모르겠어요
사월 십삼일 예약이 가능한가요?	지금 전 객실 이용 가능하세요
오버워치 깔려 있나요?	깔려 있습니다
요즘은 컴퓨터로 주문하는데 자리에 앉으셔서 한번 보시고 주문해주세요	자주 오시면 쿠폰 드릴게요
아무 자리에 나 가서 앉으면 되나요?	카드 가지고 원하는 곳에 가서 하시면 됩니다
언제 말이세요?	오월 초쯤 이용할 건데 문의 좀 하려고요
미리 계산 가능한가요?	가능합니다
여기서 짜장면 배달해서 먹어도 되나요?	되는데 흘리지 마세요
펜션에 다른 시설은 있나요?	아기들 이용하는 트램펄린 있고 노래방도 있는데 이용료가 따로 있어요
오늘 세 명으로 체크인 예정인데 확인 좀 해주실 수 있으세요?	세 분 오후 다섯시 체크인 맞습니다
방은 몇 개 드릴까요?	두 개로 주세요
이번 주는 예약 가능하나요?	이번 주는 가능해요
선불로 2시간 결제해도 되나요?	가능합니다
비상구는 어디에 있나요?	손님 뒤에 보이시는 곳이 비상구에요
체크인 시간은 몇 시부터인가요?	체크인은 오후 세 시부터 가능하세요
이용하시는 날짜 정확히 언제인가요?	4월 20일 주말에 이용하려고요
설치해 주시러 오실 때 숯 넉넉하게 가져다주실 수 있나요?	많이 가져다드릴게요
개인 풀장 사용 가능한가요?	1층에 위치한 룸은 가능해요
저쪽으로 가도 될까요?	그러세요
프론트 닫을 시간 보다 늦게오면 캐리어는 어떻게 찾아가나요?	벨을 울리면 야간 직원이 나올 거예요
성함이 어떻게 되세요?	김경아로 예약했습니다
자리 있나요?	카드 가져가시고 고르시면 됩니다
혼자 묵을 예정인데 작은 방이 있을까요?	작은 방이 있어요
숙박 좀 하려고 하는데, 어떻게 해야하나요?	1박에 5만 원이에요
룸에서 음식을 배달해 먹을 수는 있나요?	저희가 룸서비스를 오후 열 시까지 운영을 하기 때문에, 객실에서는 음식을 시켜 드실 수가 없어요. 열 시 이후에는 음식 배달이 가능해요
25일 펜션 예약 가능한가요?	그럼 25일부터 1박 2일 5인 펜션 예약 도와드릴게요
예 여기는 시간당 돈도 안 받고 하는 건가요?	그리고 가르쳐줄 사람이 없습니다
예약 번호 좀 알려주실래요?	약번호는 1234567입니다
근처에 마트는 어디에 있나요?	차 타고 10분쯤 가시면 하나로마트가 있어요
네, 체크아웃은 몇 시인가요?	체크아웃은 정오까지 하시면 돼요
온돌방 3인 하루 숙박 맞으시죠?	여기 열쇠 있어요
잠시만요, 몇 분이신데요?	성인 두 명이에요
패밀리 디럭스는 얼마인가요?	주말 가격이 적용되어 이십만원이에요
이번 토요일 말씀하시는 거죠?	십육 일쯤
체크인은 몇 시까지 하면 되나요?	오후 3시까지는 해주셔야 해요
네 예약 알림 서비스가 있는데 신청하시겠어요?	문자로 오는 건가요?
카카오페이나 삼성페이도 가능할까요?	카카오페이는 안 됩니다
여기 시간당 얼마인가요?	저희 지점은 1시간당 1200원입니다
총 몇 분이세요?	5명이요
몇 분 주무세요?	명예
주차공간은 넓은가요?	넓은 편이고 발레 서비스 해드려요
커피숍이나 수영장 이용할 수 있는 시설은 아무것도 없는 거죠?	수영장은 없고, 호텔 일 층에 커피숍은 있어요
여기 만 2천 원이고 1시간 쓸게요	1번 자리 가시면 됩니다
투숙객 할인쿠폰 발행 있나요?	워터파크 사우나 10프로 할인쿠폰 드려요
대학생 할인은 없나요?	학생증을 보여주시면 10퍼센트 할인해드립니다
일반방과 프리미엄방은 뭐가 차이가 있죠?	방 사이즈나 설치된 비품들에서 조금 차이가 나요
다른 손님들도 바비큐장을 많이 이용하시나요?	현재로는 그날에 다른 손님들은 없어요
카드 결제 가능하죠?	카드 결제 돼요
포켓볼 대는 있나요?	있습니다
펜션 차도 이용할 수 있나요?	펜션 차는 이용할 수 있는 차가 없어요
음식 주문은 여기 와서 하면 되나요?	자리에서 음식 주문해주시면 됩니다
예약하시고 오셨나요?	홍길동으로 3명 예약했습니다
지금 이용 가능한가요?	가능하세요
이게 회원가입을 해야만 사용이 가능한?	비회원도 사용 가능하지만 요금이 조금 더 비쌉니다
네, 홍길동 고객님 투룸 2개 예약 맞으신가요?	투룸 2개 예약했어요
사인이시면 객실은 두 개를 이용해야 하세요. 원하시는 날짜가 어떻게 되시나요?	오월 오일쯤이요
3자리 있나요?	저쪽에 있습니다
30분 뒤에 방문하려고 하는데 15명 단체 방문 가능할까요?	가능합니다
패밀리 트윈은 가격 어떻게 되나요?	주중이라 일반 타입은 십이만 오천 원이시고, 오션뷰 하시면 십삼만 오천 원이에요
4인실엔 침대가 몇 개인가요?	4인실엔 큰 사이즈 침대가 2개 있어요
선불인가요?	처음 이용 시간만 선불이고 나머진 후불입니다
오션뷰인가요 씨티뷰인가요?	씨티뷰 있어요
청소년들도 많이 이용하나요?	학생들이 좀 있기는 한데 많지는 않아요
조식은 되나요?	무료 조식은 없고 따로 신청하시는 거 있는데 그건 유료예요. 안내 보시고 예약하시면 돼요
음식 주문은 자리에서 가능한가요?	즐거운 시간 되세요
포켓볼 자리 나오면 화장실 다녀올 동안만 맡아주세요	알겠습니다
온돌방인가요? 침대방인가요?	다 침대고, 객실에서 문 열면 뷰도 기가 막히죠
한 달 머무를게요	장기투숙은 한 달에 60만 원이에요
방 이름이 뭐였어요?	방 이름은 잘 모르겠네요
5시간 하면 얼마에요	5시간 5000원입니다
아침 식사는 호텔 내에서 가능한가요?	아침 식사는 호텔에서 가능하세요
성함이 어떻게 되시죠?	저는 김 고객입니다
혹시 화장실 어디에요?	쭉 가다가 우회전화 시면 돼요
그냥 방 2개로 해주실래요?	6명 2개 방 예약해드릴게요
3명 잘만 한 방 있나요?	스탠더드 있어요
근처에 편의점이나 슈퍼가 있나요?	캠핑장 주차장 왼편으로 50m 올라가시면 매점이 있어요
제가 예약한 방이 이 방인가요?	내일 퇴실하실 때 쓰레기는 따로 모아서 문 앞에 놔주세요
중국집에서 배달 오면 저쪽으로 부탁해요	드시고 그릇은 당구장 밖에 부탁드려요
여기 주차할 공간은 따로 없나요?	이 건물 옆에 주차타워가 따로 있습니다
퇴실은 몇 시까지인가요?	낮 12시까지는 퇴실하셔야 해요
다음 주 무슨 요일인가요?	다음 주 목요일, 금요일이요
담배는 어디서 피면 되나요	모든 객실은 금연이니 건물 밖 흡연 공간을 이용해주세요
그때는 따로 시즌이라서 가격이 오르고 이런 건 없는 거죠?	성수기 금액이 적용되지는 않는데, 연휴라서 예약은 빨리 하셔야 할 거예요
캐라반 가지고 오시게요?	캐라반 대여하려는데
회원가입은 어떻게 해요?	원하시는 자리에 앉으셔서 컴퓨터로 회원가입하시면 돼요
펜션 근처에 둘러볼 만한 관광지도 있어요?	해동 용궁사가 바로 앞에 있어요
저희 바비큐도 할 건데 장비를 빌릴 수 있나요?	숙박비용에 포함돼있어요
와이파이도 공용으로 되어 있나요?	비밀번호는 벽에 붙어 있어요
와이파이는 설치되어있나요?	와이파이 설치되어 있습니다
이틀 숙박하려고 하는데요	내일모레까지 사용하시는 거죠?
1명이요	뒤에 있는 키오스크에서 자리 배정받으시면 됩니다
칫솔은 가져가야 해요?	칫솔은 손님이 갖고 오셔야 해요
침대는 몇 개인가요?	침대는 두 개입니다
이번 주에 예약 가능한 방이 있나요?	1층 4인실로 예약해드릴게요
4구로 게임 가능할까요?	저쪽에서 하시면 됩니다
트윈룸에 바다 전망으로 예약했는데 맞나요?	바다 전망이에요
룸 업그레이드 하면 가격이 많이 다른가요?	15000원 정도 차이 난다고 보시면 돼요
수영장은 이용료가 얼마예요?	수영장은 칠만원에 온수 사용요금은 별도예요
자차 이동 시에 호텔 측에서 발레파킹도 해주나요?	비즈니스호텔은 발레파킹, 벨맨, 룸서비스가 제공되지 않아요
체크인은 몇 시까지 해야 되는지요?	따로 체크인 시간은 정해져있지는 않아요
음식을 주문하려고 하는데 현금으로 가능한가요?	가능합니다
호텔 이용하게 되면 편의시설은 어떤 거 이용할 수 있어요?	사우나, 오락실 있고 아기들 좋아하는 '뽀로로 아쿠아 빌리지'라고 수영장 있어요
네, 어떤 방 원하세요?	3명이서 잘 방이요
청소년들은 몇 시까지 이용이 가능한가요?	청소년들은 아침 9시부터 저녁 10시까지 이용 가능합니다
배달시켜 먹으려는데 배달되는 가게 중에 괜찮은 곳 좀 추천해 주실래요?	족발 가게 전화번호를 알려드릴게요
2박 예약 되나요?	침대를 싱글로 두 개 가능할까요?
네, 몇 분 정도 숙박하실 예정이신가요?	어른 둘 아이 둘이요
3구 공 있나요?	지금 다 이용 중이라 없습니다
주차는 몇 대까지 가능한가요?	주차는 객실당 1대만 가능해요
어떤 방이 남아있나요?	금연실 2개와 흡연실 1개 있어요
오션뷰로 드릴까요?	80000원이에요
얼마나 기다려야 하나요?	10분 정도면 될 것 같습니다
추가 비용은 언제 계산해요?	추가 비용은 체크아웃하실 때 계산하시면 돼요
혹시 계란 반숙 가능한가요?	감사합니다
페밀리룸으로 예약된 거 맞죠?	507호 키 드릴게요
현금 영수증 필요하세요?	현금 영수증 해주세요
체크아웃은 언제인가요?	11시예요
여기 펜션만의 특색이 해수 온천이 있다고 하던데요?	펜션 앞에 해수 온천, 온천 랜드가 있어요
대실과 숙박 중 어느 쪽인가요?	대실이요
온돌 방도 괜찮으세요?	상관없어요
차량 주차되나요?	차량은 모텔 주차장에 주차하시면 돼요
화장실은 어디 있어요?	2층으로 올라가는 계단에 있어요
어떤 부분 말씀하시나요?	식사나 이런 것들 저희가 주문하면 가능한지요?
성함이 어떻게 되시죠?	김철수입니다
몇 장 필요하세요?	잠시만 기다리세요. 챙겨드릴게요
한 게임 당 얼마인가요?	저희는 서비스를 더 드리기 때문에 가격이 조금 비쌉니다
배그 되는 자리 어디 어디 있어요?	1번부터 40번까지는 배그 전용석이고 나머지 자리도 배그 돌아가긴 합니다
짜장면 2개와 탕수육 세트로 하나 주문해주세요	주문해드리겠습니다
바비큐는 사용료 드려야 하죠?	바비큐 사용료는 1인당 5천원 있어요
당구 몇 치시나요	150 칩니다
얼마인가요?	3500원입니다
조금 더 일찍 체크인 안될까요?	일찍 오시면 추가 금액이 있어요
그럼 사장님 언제나 오세요?	사장님 보통 저녁에 나오시는데요
세 명이 사용할 건데 요금이 달라지나요?	2명 기준 2만 5천 원이에요. 한 분은 추가요금 5천 원 더 결제해주시면 돼요
네, 성함이 어떻게 되시죠?	김재영이에요
몇 시부터 식사할 수 있어요?	오전 7시부터 가능해요
단무지도 같이 주시나요?	드립니다
호텔이 어디에 위치한 건가요?	저희 호텔은 경주 불국사 쪽에 있어요
체크인은 몇 시쯤 예상하시나요?	오후 3시쯤 체크인하겠습니다
이번 주 주말 1박 2일로 되나요?	가능하세요
방은 있는데 몇 분이세요?	사인인데요
다다음 주 토요일쯤이요?	다음다음주 토요일에요
그럼 다른 자리에 있다가 옮겨도 되나요?	자리 나면 알려드리겠습니다
무슨 방 무슨 방 남았죠?	일반실 2개와 특실 1개가 남아 있어요
몸만 오시면 돼요, 날짜가 언제쯤인가요?	3월 16일이나 23일이나
혹시 원하시는 방이 있으신가요?	바다가 잘 보이는 방이었으면 좋겠어요
체크아웃은 언제 하면 되나요?	27일 오후 12시 전에 체크아웃 해 주세요
음료 한잔 더 마실 수 있을까요?	똑같은 걸로 가져다드리겠습니다
청소년들은 이용시간이 몇 시까지 인가요?	청소년들은 밤 10시까지만 이용 가능해요
주차공간은 넉넉한가요?	주차 공간은 총 30개로 넉넉한 편이에요
시간당 얼마죠?	1인당 30분에 1000원입니다
세면도구는 따로 구매해야 하나요?	세면도구는 천 원에 구매하실 수 있어요
대실과 숙박 중에 어느 것으로 하실 건가요?	숙박이요
배틀그라운드 같은 게임들 다 원활하게 돌아가는 사양인가요?	컴퓨터 사양이 배틀그라운드 같은 게임들 다 원활하게 돌아가요
한 시간 가격은 얼마인가요?	한 시간에 1000원이에요
저희 팀원이 한 명 비는데 같이 치면 안 될까요?	청소가 밀려있어서 힘들 것 같네요
근처에 마트는 좀 있나요?	바로 앞에 편의점이 있어요
연계된 렌터카 회사가 있나요?	에이제이 렌터카라고 저희와 제휴가 되어 있어요. 번호를 알려주시면 그쪽으로 연락을 해드리는 방식이에요
수영장은 몇 시부터 이용 가능한가요?	9시부터 6시까지 이용 가능하세요
거기 캠핑장이 있어예?	저희는 캠핑장은 따로 없어요
날짜는 언제로 해드릴까요?	이번 주 토요일, 일요일 1박 2일로 예약 부탁드립니다
주변에 숯을 살만한 곳이 있을까요?	차로 5분 정도 나가면 작은 마트가 있어요
음료수는 서비스인가요?	원하시는 만큼 드셔도 됩니다
룸에서 배달시켜 먹어도 되나요?	배달은 상관없는데 배달음식은 많지 않아요
조식은 몇 시까지인가요?	오전 10시까지에요
지금 체크인할 수 있나요?	체크인은 2시 이후에 가능해요
예약 가능한가요?	6분이시면 작은 방을 2개 하시든지 큰 방에 추가해서 들어가는 방법 있어요
삼월 삼십일 주말에 토요일 예약이 가능한가요?	디럭스 패밀리룸 가능하세요
모닝콜 서비스는 가능한가요?	미리 말씀해주시면 모닝콜 서비스 해드려요
죄송한데 화장실은 어디 있나요?	출입문 오른쪽으로 돌면 있고 열쇠 가지고 가세요
당구장 영업시간이 언제까지 입니까?	손님들이 계실때까지 영업하는 거죠
여기 이벤트같은 진행하는 게 있나요?	이벤트는 예정 중입니다
내일 몇 시까지 방 비우면 되죠?	9시까지에요
제휴 할인 카드 같은 거 있나요?	아직 카드사와 제휴된 곳은 없어요
장갑 빌릴 수 있을까요?	재밌게 치세요
비상구는 혹시 어느 쪽에 있나요?	비상구는 저기 뒤쪽에 있습니다
사장님 시간당 얼마에요?	인당 시간에 3000원이요
알겠습니다, 고민해보고 전화드릴게요	전화주세요, 감사해요
결재할 때 카카오페이 가능한가요?	카카오페이도 가능해요
현금영수증 해주세요	번호 입력해주세요
그럼 라면 하나하고 찐 계란 한 개 부탁합니다	바로 갖다 드리겠습니다
음식 배달도 되나요?	직접 주문하시면 됩니다
오늘 하루 묵을 건데 방 남은 거 있나요?	현재 방 3개가 남아 있어요
뭐가 이렇게 비싸요?	사장님이 그렇게 책정하셨어요
냉장고 안에 있는 음료는 가져가도 되나요?	드실 만큼 가져가셔도 돼요
포켓볼 한 시간에 얼마에요?	한 시간에 3000원이요
주차비용은 따로 내나요?	무료예요
네이버로 예약하면 할인되는 그런 건 없죠?	이버로 예약해도 요금 비슷해요, 마일리지가 쌓여야 공짜로 이용하든지 해요
숙박하려는데 방이 있나요?	있어요
성함이 어떻게 되세요?	홍길동이요
카드 결제 부탁드릴게요	카드 결제 해드릴게요
체크인 체크아웃 시간은 어떻게 되나요?	2시에 체크인하셔서 다음날 오전 11시까지 체크아웃 해주시면 돼요
3개나 2개는 안 돼요?	그렇게 큰 방은 없어요
확인되셨고, 1인실 맞으시죠?	체크인은 3시부터라 좀 기다리셔야 할 거 같아요
혹시 피씨방 예약도 가능할까요?	피씨방 예약은 안 됩니다
특실과 일반실 어디로 드릴까요?	거울 사면으로 도배된 방 4만 원이에요
이틀 사용으로 예약하셨네요?	맞습니다
네, 내일 예약이신가요?	약 가능하신데, 크리스마스이브라 가격이 좀 올라가요
카드 결제도 가능한가요?	현금만 받고 있습니다
안에 콘돔 있나요?	기본 콘돔 말고는 자판기에서 구매하시면 돼요
혹시 출력이 가능할까요	프린트하시면 장당 200원에 계산됩니다
하루숙박비가 얼마정도 하나요?	4만원, 5만원, 6만원이에요
청소년들은 몇시까지 이용할 수 있나요?	알기론 제한이 없는 걸로 알고 있어요
13일 주말, 성인 2명이 묵으려고 하는데 숙박료가 얼마예요?	성인 2명 주말 금액은 12만원이에요
몇 분이세요?	작은방으로 드릴게요
오늘 체크인하는 사람인데, 확인해주실래요?	일반실 1박 확인되었어요
차량 번호 알려주세요	여기 키 받으시고 방으로 올라가시면 돼요
장갑 빌릴 수 있을까요?	천 원입니다
현금결제할게요	팔만 원 현금으로 받았어요
엑스트라 베드 추가할 경우 추가 요금이 발생하나요?	2만 원 추가 요금 발생해요
네, 몇 명이신가요?	3명이에요
바다 쪽은 트윈 베드 룸만 남아있는데, 괜찮으세요?	시티뷰쪽으로 드릴게요
숙박하려고 하는데 1인 추가 가능한가요?	1인 추가 금액은 10000원이에요
재료는 직접 사 와야 하나요?	근처에 슈퍼마켓이 있어요
체크인 시간은 몇 시에요?	3시부터 입실인데 2시에서 2시 반에도 가능해요
바비큐 추가되나요?	1인당 10000원이에요
비상구는 혹시 어디에 있어요?	비상구는 뒤쪽 보시면 있습니다
결재할 때 카카오페이 가능한가요?	카카오페이 가능하세요
네 빨리 부탁드려요	알겠습니다
크리스마스이브에 6명이 갈 건데, 방 2개 예약되나요?	4인 2인으로 나누면 가능해요
조식 포함되어 있나요?	1층 로비에서 아침 드실 수 있어요
오월 오일 일요일 말씀이시죠?	오월 오일 어린이날이에요
방은 오션뷰로 가능할까요?	오션뷰 방으로 확정되었고, 뒤에 보이시는 엘리베이터 타시고 304호로 가시면 돼요
더블룸으로 예약하셨나요?	스탠더드로 예약했어요
주차 어디에 했어요?	여기 바로 앞에 있는 주차장에 했어요
청소년도 이용할 수 있나요?	청소년들도 이용 가능하죠
라면도 끓여주시나요?	저희는 사발면만 판매합니다
차로는 얼마 정도 걸려요?	차 이용하면 10분 정도요
사월 말경에 사인 가족 한 번 가려고 하는데 금액이 어떻게 돼요?	사월은 아직 가격 책정이 안 돼서 말씀드리기가 그렇네요
숙박비용은 얼마인가요?	일박에 5만 원이에요
사장님 여기 3명 4구로 하겠습니다	편한 판에서 하시면 됩니다
거기 카드 되나요?	주문할 때 말씀하시면 됩니다
네, 몇 분이세요?	있어요
한 명 추가당 비용을 더 받나요?	만 원 추가되세요
몇 분이신데요?	잠시만 기다려주세요. 바로 알아볼게요
1박 하실 건가요?	더블룸 1박에 4만5천 원이에요
입실은 몇 시부터에요?	2시부터입니다
온수 잘 나오죠?	그럼요. 잘 나와요
이 가격에 조식이 포함된 건가요?	아니요, 조식은 추가 결제인데, 두 분이 삼만원 추가하면 뷔페도 이용 가능하세요
공항 셔틀버스는 이용할 수 있나요?	셔틀버스는 따로 이용할 수 없어요
바비큐도 추가하려고 하는데요?	바비큐는 3만 원 추가해주시면 되세요
방이 1층과 2층에 있는데 어느 층 방으로 드릴까요?	2층에 있는 방으로 주세요
혹시 여기 프린트는 되나요?	전 좌석 프린트 가능합니다
이번 주말 예약 가능한가요?	가능해요
평일은 18만원이에요?	평일은 18만원이에요
저기 이것 좀 봐주시겠어요?	잠시 봐드릴게요
카카오페이 가능한가요?	카카오페이는 현재 안 쓰고 있어요
대실은 몇 시간인가요?	대실 사용시간은 3시간이에요
탕수육 둘, 짜장면 둘, 짬뽕 둘 주문해주세요	알겠습니다
프린터기 사용되나요?	됩니다
시간당 얼마인가요?	1시간에 1200원입니다
여기 한 달씩도 방 해요?	달방 가능해요
언제인가요?	저녁 아홉시부터 진행하고 있어요
당구대에 열선이 깔려있나요?	당구대에 열선 깔려서 따뜻하게 당구 즐기실 수 있습니다
바다가 보였으면 좋겠는데 가능한가요?	현재 바다가 보이는 방은 예약이 꽉 찼어요
공항까지 셔틀버스 운영을 하나요?	저희는 셔틀버스는 없어요
여기 회원제 할인도 되나요?	회원이시라면 시간당 200원 할인이 되시며 누적 시간 사용 가능합니다
할인되는 방은 없어요?	모닝 릴레이 패키지라고 객실, 조식 두 분, 키즈 텐트, 키즈 세트 이렇게 제공해 드려요. 조식은 성인 것만 추가하시면 돼요. 삼십이만 원에 아이들한테 증정되는 키즈 장난감, 어린이 시계, 어린이 백팩, 우드 퍼즐도 제공해드리고 있어요. 체크인 체크아웃도 저희가 조정을 해드릴 수 있어요
혹시 모텔에 트윈베드 룸이 있나요?	트윈베드 룸 이용 가능하세요
여기 주차할데 없죠?	주차공간은 따로 없습니다
사장님 여기 3구로 바꿀 수 있나요?	바꿔드릴게요
추가 요금은 어떻게 되나요?	15분당 천 원씩 추가됩니다
조식도 예약하시나요?	조식도 2명 같이 예약할게요
편의점도 바로 앞에 있나요?	편의점은 일 분 거리에 있어요
물은 일 인당 몇 개예요?	객실에 예약을 네분 하시면 기본적으로 네 병이 들어가 있어요
가족이신가요?	한 가족이에요
그리고 짜장면 시켜도 되나요?	가능합니다
영업시간은 몇 시까지인가요?	24시간 영업합니다
여긴 당구대 몇 개 있나요?	3구와 4구 전용 6개 있고 포켓볼 전용 3개 있습니다
오늘 처음 왔는데 이용 요금 안내 좀 해주시겠어요?	40분에 천 원입니다
귀중품은 따로 보관 가능한가요?	귀중품은 데스크에 맡기실 수 있어요
제가 의논해보고 다시 전화드릴게요	전화주세요
룸에서 배달음식 시켜 먹어도 되나요?	배달음식은 상관은 없으셔요
바비큐 예약 시 인원수에 맞게 예약하는 건가요?	인원수에 따라 예약해야해요
언제 숙박하실 계획이세요?	이번 주 일요일부터 다음 주 화요일까지요
여기 프린트랑 스캔도 되나요?	프린트는 100원 스캔은 500원입니다
결제는 어떻게 도와드릴까요?	결제 진행해 드릴게요
몇 분이신가요?	죄송하지만 현재 6인실 파티룸 밖에 없어요
그러면 그냥 옆에서 코치 해주신다는 거죠?	해드립니다
네 식사 좀 시켜 먹겠습니다	편하게 드세요
청소년들도 이용이 가능한가요?	가능하고 이용 제한 시간도 없어요
이불 추가로 받으면 추가 요금 있나요?	추가 요금 따로 없어요
다가오는 토요일 말이세요?	다가오는 토요일이요
체크아웃 시간은 몇 시인가요?	오전 11시 30분 전에 체크아웃 하시면 돼요
음료수는 아이스 티로 주세요	곧 가져다드릴게요
시간당 요금은 얼마인가요?	시간당 1500원입니다
혹시 잔돈 있으신가요?	있습니다
1시간에 얼마인가요?	1500원입니다
컴퓨터 사양은 혹시 배틀그라운드가 잘 돌아갈 수 있을까요?	배틀그라운드 잘 돌아갑니다
어린이 한 명 추가하면 룸을 바꿔야 하나요? 아니면 추가 비용을 내야 하나요?	룸에 침구를 추가하면 만원이에요
저희 방은 어디에 위치해있나요?	3층 중앙홀 305호에 있어요
사우나는 입장권이 얼마예요?	사우나는 투숙객에게 오십 프로 할인이 적용되셔서 성인은 만 천 원, 어린이는 오천오백 원이에요
마세유 가능한가요?	300 이상이면 가능하십니다
짜장면 배달 시켜도 되나요?	가능합니다
1박에 얼마인가요?	15만 원이에요
자리 있나요?	창가 쪽에 한 자리 남아 있습니다
보관함 이용료 결제는 카드도 가능한 거죠?	하지만 고객님은 멤버십 혜택으로 무료로 이용 가능해요
한 장에 얼마인가요?	흑백은 200원이고 칼라는 500원입니다
여기 요금이 얼마에요?	40분에 1000원입니다
몇 박 묵으실 예정이실까요?	금토일 3일로 2박 3일이 가능한지 알고 싶습니다
너구리로 4개 해주세요	준비되면 자리로 갖다 드릴게요
리니지 되는 자리 있나요?	10분 정도 기다려야 됩니다
조금만 생각해보고 다시 전화드릴게요	전화 주세요
텐트나 캠핑 도구들 대여도 가능한가요?	텐트는 대여 가능하고 캠핑 도구들은 특정 품목들만 구비하고 있어요
음식 가지고 가도 괜찮나요?	주류만 아니면 괜찮습니다
조금 상의해서 다시 전화드릴게요	전화 주세요
오늘 숙박 가능한가요?	숙박 가능해요
여기 한 시간에 얼마에요?	천 원입니다
지금 체크인 도와주실래요?	예약하신 방은 블루방이고 여기 키 있어요
바비큐장은 이용할 수 있나요?	바비큐장은 있어요
흡연실은 있나요?	마지막 당구대 자리 옆쪽에 있어요
프린트 할 수 있나요?	프린트 가능합니다
그럼 삼성페이나 카카오페이 이런거도 안되는 거죠?	삼성페이나 카카오페이도 결제 어렵습니다
한 방에 몇 명 수용 가능하나요?	4인 기준입니다
이번 주 토요일 남아 있는 사이트 있나요?	A 사이트와 B 사이트 있어요
한 10분에서 길면 20분 정도 기다리셔야 하는데 기다리시겠어요?	오른쪽에 소파에 앉아계시면 불러드릴게요
이번 주말 예약 가능한가요?	이번 주말은 일요일만 가능해요
일반실과 특실 차이가 무엇인가요?	특실이 더 넓고 제공되는 서비스가 다릅니다
포켓볼 자리 있나요?	있습니다
몇 분이신가요?	어른 2명, 아이 2명, 강아지 1마리입니다
전망이 좋고 고층에 있는 객실 있나요?	현재 남아 있는 객실 중에는 15층 객실이 전망이 제일 좋은데 그쪽으로 안내해 드릴게요
오류사항 없으시고 카드 선결제 해드릴까요?	30만 원이고 카드 결제 해드릴게요
장갑 어디 있나요?	카운터 옆에 있어요
선불로 내야 하나요?	후불로 하시면 됩니다
그럼 조금 있다가 부탁드릴게요	재미있는 시간 되세요
호텔 편의시설은 어떤 것이 있어요?	사우나 정도 하실 수 있는 부띠끄 호텔이라고 생각하시면 돼요
여기 혹시 피씨방 영업시간이 언제까지 인가요?	24시간입니다
새벽이라 사장님이 전화를 안 받아오셔서 그런데 연락처 주실 수 있어요?	사장님 번호는 3333에 3333이니까 이쪽으로 연락 주시면 됩니다
제가 오늘 처음 와서 그런데 회원 가입은 어떻게 해야 해요?	옆에 보시면 회원가입하고 결제하는 기계 있어요
저 텐트 앞에 하나 설치해주실 수 있을까요?	5분 뒤에 바로 설치해드릴게요
바비큐용 숯불도 팔아요?	참숯 팔고 있어요
포켓볼 할 건데요	3번 자리로 가세요
토스트하고 커피 같은 것들이 나오는 모양이죠?	커피는 원두커피고 음료수랑 과일 종류도 같이 많이 나가요
하루 더 숙박하려고 했는데, 취소하는 사람 없을까요?	그 때가 벚꽃놀이 시즌이라 아마도 취소하는 분은 안 계실 거예요
예약하셨나요?	김영철 이름으로 예약했습니다
2인실 침대방으로 할 게요	아기침대는 없어요
풀장 이용 가능한가요?	가능해요
포캣볼도 있나요?	포켓볼은 아쉽게도 아직 들어오지 않았어요
포켓볼 말고 4구도 있죠?	포켓볼은 두 테이블 준비되어있고 4구 테이블도 따로 마련되어 있습니다
12번 자리에 2시간 추가 넣어주세요	2시간 추가 넣어드렸습니다
기본요금도 있나요?	5000원입니다 10분만 이용하셔도 5000원 내셔야 합니다
계산은 카드도 가능한가요?	카드로도 결제 가능하세요
어제 예약 전화 드렸었는데요	김기동 고객님 이쪽으로 오세요
1층에서 7박 하시는 분이시죠?	맞아요.
네, 카드로 하실 건가요?	결제 완료 되었어요
룸 업그레이드도 가능한가요?	죄송하지만, 현재 업그레이드는 불가능해요
흡연실도 따로 다 마련이 되어있구요?	흡연실도 있습니다
날짜로 어떻게 되죠?	삼월 삼 일부터 육일까지요
할인 카드 없죠	할인 카드 없어요
한 시간으로 끊어주세요	도와드리겠습니다
전화번호 알려주시겠어요?	01012345678입니다
10분에 요금은 얼마정도 하나요?	1300원, 1500원, 1700원 이렇게 3종류에요
3분이시면 온돌방으로 드릴까요?	온돌방으로 주세요
방법은 아시죠?	자주 쳐봐서 알아요
몇 분이시죠?	1박에 6만 원이에요
일 인당 생수 몇 병이에요?	일 인당 각각 세병까지 들어가 있어요. 인원 추가하실 경우에 네분이시면 네 병이 나가고 있어요
후불도 가능한가요?	후불은 안됩니다
네 계산은 미리 해야 하나요?	다 치시고 하시면 돼요
한 룸당 최대 인원이 4명이에요	방 2개 예약할게요
무제한으로 하겠습니다	4만 원 결제 도와드리겠습니다
방이 2층에 하나 3층에 하나 있는데 어디로 드릴까요?	2층 방으로 주십시오
4구로 주시겠어요?	갖다 드릴게요
네 식사는 어떤 종류가 있나요?	여기 메뉴판에서 고르시면 돼요
3월 30일 맞으신가요?	3월 23일이요
야외에서 숯불구이 하고 싶은데요?	추가 금액만 지불하시면 돼요
대게 때문에 예약이 빨리 된 거 아니에요?	대게 때문이 아니라 연휴도 있어서 예약이 좀 빨리 된 거 같아요
룸서비스는 가능한가요?	숙박만 가능하시기에 룸서비스 없어요
프린트값은 제 요금에 추가 되는거 맞죠?	고객님 요금에 추가되는거 맞으세요
결제는 선불인가요?	결제는 후불이고, 나가실 때 결제해 주시면 되십니다
네  여기서 쳐도 되죠?	거기에서 치면 됩니다
조식 포함인가요?	저희는 조식 없어요
카카오페이 결제 가능한가요?	이버를 통해서 카카오페이 가능해요
주위에 볼만한 관광지 있나요?	펜션이 보문단지 안이라서 차 있으면 5분, 10분이면 다 갈 수 있어요
흡연실에 재떨이 있나요?	재떨이랑 다 구비되어 있어요
네, 어떤 방으로 예약해드릴까요	디럭스 더블룸이요
예약하고 오신 건가요?	청소 중인 방을 10분 후에 드릴 수 있어요
컴퓨터 그래픽카드 사양은 혹시 어느 정도 될까요?	그래픽카드는 다 1070이고 최신 제품은 1080티아이 이렇게 있습니다
사장님 기구에 문제가 있을 땐 어떻게 해야 하나요?	저한테 말씀해주시면 됩니다
헬스장은 이용 시간이 몇 시부터 몇 시까지인가요?	헬스장은 오전 여섯 시부터 저녁 열한 시까지 이용이에요
혹시 회원가입하면 요금이 더 싼가요?	회원 가입하시면 1시간 1000원에 이용 가능합니다
시간에 얼마죠?	1시간에 5000원이에요
옆방이 청소가 안 끝나서 30분 후에 입실이 가능한데 괜찮으시겠어요?	결제 먼저 도와드릴게요
네, 몇 분이세요?	그 날 6명 들어갈만한 방이 없는데요
조식이 뭐 어떤 음식이 나오나요?	조식이 저희는 뷔페식이에요
당구 몇 치시나요	300이하는 마세 금지입니다
앞에 초등학생들 너무 시끄러운데 조용히 시켜주시면 안 될까요?	당장 가서 저지 시킬게요
어머님이 휠체어 타세요?	어머님이 휠체어 사용 중이세요
객실 확인 좀 해주실래요?	3번 캠핑장 이용하시면 돼요
주변에 주차 가능한가요?	건물 뒤편에 공용주차장이 있습니다
그냥 빈 곳에 앉아서 기다리면 되나요?	입구 앞 의자에서 대기 부탁드려요
와이파이는 다 설치되어 있나요?	와이파이는 다 설치되어 있습니다
포켓볼 가능한가요?	가능합니다
체크인 시간하고 체크아웃하는 시간이 어떻게 돼요?	체크인 시간은 오후 두 시부터 가능하시고, 체크아웃 시간은 열두 시부터 가능하세요
계산은 카드로 가능한가요?	카드기 준비중이여서 카드 결제는 어렵습니다
몇 분이 쓰실 건가요?	여섯 명에 강아지 한 마리요
주말 가격은 어떻게 되나요?	주말은 인당 2만 원 지불 시 80분 이용 가능하십니다
저희가 어른하고 의논하고 다시 예약을 잡도록 할게요	어른들과 의논하고 예약하세요
수건 추가 가능한가요?	인터폰으로 연락 주시면 추가해드려요
체크아웃은 몇 시인 가요?	11시예요
침구는 여유 있게 구비되어 있나요?	여유 있게 이용 가능하시도록 준비되어있어요
주변에 아침 식사 가능한 곳은 있어요?	저희 뷔페식으로 조식 준비되어 있고 호텔 가까이에 '오복 미역'이라고 미역국 전문점도 있어요
오늘 방 2개 있나요?	506호 507호 있어요.
미리 선 결제하면 할인되는 거 있나요?	10시간 단위로 정액제 하시면 할인도 되고 1시간 무료 서비스 있습니다
요금에서 깎아주실 수는 없나요?	지금 가격이 많이 내린 건데 제가 19만원까지 해드릴게요
성함과 연락처 말씀해주시겠습니까?	홍길동이고 연락처는 01012345678입니다
외부음식 반입이 되나요?	외부음식은 반입은 안 됩니다
침대 시트를 갈아주세요	침대 시트 바로 갈아드릴게요
혼자 묵을 만한 작은 침대방으로 안내해 주세요	작은 침대방으로 드릴게요
1장 인쇄하는데 비용이 얼마인가요?	흑백은 1장에 100원 컬러는 200원입니다
당구장 영업시간이 어떻게 되나요?	영업시간이 오전 12시부터 새벽 3시까지에요
방을 인터넷에서 보셨어요?	방이 일반 방도 있고 제트스파방도 있고 여러 가지가 있어요
조식은 어떻게 되나요?	조식은 지금 없어요
요금 지불은 카드로도 가능한가요?	저희는 카드 단말기가 없어서 불가능합니다
와이파이 있나요?	여기에 있습니다
체크아웃은 몇 시인가요?	오전 10시까지이에요
사월 십삼일 토요일 맞아요?	사월 십삼일 토요일이에요
2시간이요	저기 무인 기계에서 결제해주세요
샤워용품이 있나요?	방에 샴푸와 보디워시는 있어요
주말에 예약이 가능한가요?	바다가 보이는 방이랑 안 보이는 방이 있어요
5시간 충전해주세요	충전되셨어요
잠시 쉬었다 가려고요	대실은 3만 원이에요
흡연실도 따로 있나요?	따로 준비되어 있는데 이용 시 바닥에 침만 뱉지 말아주세요
이불은 넉넉히 있나요?	이불은 넉넉하세요
그럼 2시간 충전할게요	충전은 저쪽에 기계에서 하시면 됩니다
보상으로 방 등급을 한 단계 더 좋은 걸로 해주세요	한 등급 높은 방으로 바꾸어 드릴게요
삼성페이랑 카카오페이도 돼요?	카카오페이는 안 되는데 삼성페이는 됩니다
2박 하려는데 방 안 옮기고 연박할 수 있나요?	그렇게 해드릴게요
25일 펜션 예약 가능한가요?	가능해요
요일이 무슨 요일이세요?	토요일 거예요
여기 커플석은 있나요?	커플석은 없습니다
FPS 전용좌석이 별도로 조성되어있나요?	아니오 별도로 지정되어있지 않습니다
이런 룸 컨디션이면 더 좋은 방으로라도 바꿔줘야 하는 거 아니에요?	스위트룸 남는 방으로 변경 해드릴게요
오션뷰로 하고 싶은데 남은 방 있나요?	예약되었어요
이번 주 토요일 맞으세요?	4월 6일 토요일에요
바비큐장 시설 7시까지 준비해 주실래요?	알겠어요.
자리 있어요?	만석입니다
성인 2명, 어린이 2명인데 추가 요금 받아요?	어린이는 5살 이상이면 성인요금으로 받아요
친구가 여기 있는데 옆에서 지켜보고 있어도 되나요?	사용료를 지불하시고 이용해 주세요
음식이나 필요한 건 어떻게 주문하나요?	다른 거 필요하신 거 있으시면 컴퓨터로 말씀해주세요
20시간짜리 하나 만들어주세요	여깄습니다
날짜는 언제로 하시는데요?	저희가 오월 초에요
야놀자'에서 예약하는 것보다 전화로 예약하면 할인을 좀 해주시나요?	전화 예약은 조금 할인해 드려요
여기 혹시 영업시간이 언제까지 인가요?	저희는 24시간 영업합니다
계산은 카드로도 되는가요?	카드는 후불 결제만 가능하세요
전자레인지나 인덕션, 컴퓨터는 구비가 되어있나요?	전자레인지는 오층 복도에, 컴퓨터는 로비에 있고 인덕션은 없어요
후불로 해도 가능한가요?	처음에는 무조건 선불로 시작하셔야되고 더 필요하시면 후불로도 가능하세요
취사는 정해진 장소에서만 해야 하나요 아님 개인 방에서 가능할까요?	개인 룸 내에 마련된 바비큐 장소에서 하시면 돼요
한 시간에 얼마에요	2000원이요
이용할 수 있는 편의시설은 어떤 게 있나요?	편의시설은 없고 숙박만 가능하세요
네 혹시 첫 방문이신가요?	이 매장은 첫 방문입니다
6인실은 가격이 어떻게 되나요?	6인실은 12만 원이에요
원룸 형태는 괜찮으신가요?	원룸은 괜찮은데 6명이라서
엘리베이터가 어디 있나요?	엘리베이터는 왼쪽으로 쭉 가시면 있어요
3명 묵을 방 있나요?	2인실에 한 명 추가하셔도 되고 4인실을 이용하셔도 돼요
그럼 한글 프로그램 되는 컴퓨터는요?	자리 현재 남아있습니다
저희가 생각해보고 다시 전화드리도록 하겠습니다, 수고하세요	전화 꼭 주세요
어떤 음식으로 식사 준비해드릴까요?	햄버거 주문할게요
네, 고객님 예약번호랑 여권 부탁드릴게요	8층이에요
음식을 주문할 수 있을까요?	가능합니다
한 객실에 몇 명까지 숙박 가능한가요?	3명까지 가능해요
여기 1게임 비용이 어떻게 되죠?	오픈 이벤트로 오전 8시부터 오후 5시까지 인당 1만 원에 도와드리고 있습니다
무인 기계가 어디 있나요?	입구 쪽에 있습니다
룸은 미리 예약해야 되나요?	지금도 사용하실 수 있습니다
여기 방 비어있나요?	이용 가능하세요
매실차로 두 개 주세요	가져다드릴게요
a방이랑 b방 각각 뷰가 어떻게 되죠?	a방은 고층 도시 풍경이고 b방은 해변이 보여요
조식이 포함되는 가격인가요?	조식은 불포함된 가격으로 안내해 드렸어요
1박으로 하세요?	2박으로 하려고 합니다
하루 숙박에 얼마인가요?	1박에 3만 원이에요
열 번 대실 이용하면 한 번 무료 있나요?	적립은 가능하신데, 삼성페이는 적립이 안 돼요
성함이 어떻게 되세요?	박보검이요
저희 3명 모두 계산 부탁 드려도 되나요?	1인당 입장요금 2000원 추가해서 총 9만 6천 원 결제 도와드릴게요
떨어져 앉아도 되나요?	괜찮아요
네 그럼 한 시간에 얼마에요?	행사해서 천 원이에요
바로 이용할게요	편하게 이용하세요
조식도 주시는 거예요?	비즈니스 모텔이라서 밥 종류는 아니고 토스트 같은 게 나가요
커플석이라든지 이런 부분은 없나요?	커플석은 없습니다
결제는 신용카드와 현금 중 어느 걸로 하시겠어요?	약자분 성함 말씀해주세요
포켓볼도 칠 수 있나요?	되죠
숙박하려고 연락드렸는데 어떻게 예약할 수 있나요?	약센터로 돌려드릴게요
오 박사 이름으로 예약했는데 확인 좀 해주실래요?	객실은 우측 길 따라가셔셔 오션뷰 3층이세요
크기는 상관없는데 얼마예요?	현금하시면 4만 원에 해드릴게요
몇 분이나 걸릴까요?	30분 정도요
저녁에 바비큐 해 먹을 수 있나요?	7시까지 준비해드리겠습니다
제휴 카드 같은 거는 없어요?	저희가 제휴 카드는 따로 있지는 않아요
죄송한데, 숙박 날짜가 언제쯤이세요?	오월 오일쯤에요
그럼 일단 1시간만 할게요	잠시만 기다려 주세요
거기 혹시 청소는 해줘요?	청소는 해 드려요
오월 초쯤 이용하려고 하는데요?	한 객실에 네 분이 투숙하시기는 어려우세요. 두 객실로 나누어서 이용하시는 건 가능하세요
계산은 후불로 하면 되나요?	후불입니다
흡연실도 따로 마련되어 있나요?	흡연실 마련 되어 있습니다
커플석이라든지 그런 부분은 있어요?	커플석은 없습니다
혹시 여기 피씨방 영업시간이 언제까지 인가요?	24시간 영업입니다
네, 맡기실 짐이 몇 개인가요?	세 개에요
상의해보고 다시 전화드리도록 하겠습니다, 감사합니다	꼭 전화주세요
4명이 나란히 앉을 자리 있나요?	앞뒤로 둘둘씩 앉을 수 있는 자리 있습니다
오션뷰와 시티뷰 어느 쪽으로 하시겠어요?	오션뷰로 주세요
주변에 가 볼만 한 곳이 있나요?	도보로 십 분 정도에 케이블카, 오동도, 낭만포차, 벽화마을이 있어요. 보통 걸어서 많이 다니세요
총원 몇 명이신가요?	총 6명이요
칫솔 하나 더 주실 수 있나요?	칫솔 하나 더 드릴게요
강남구에 있는 힐튼호텔 맞나요?	힐튼호텔이에요
네, 현금이신가요?	카드로 계산할게요
여기 한 시간에 얼마인가요	한 시간은 1200원이고 5시간부터는 더 쌉니다
음식 주문도 가능한가요?	자리에서 먹고싶은거 컴퓨터로 주문하시면 됩니다
커플석이라던지 그런건 혹시 있나요?	커플석 그런거는 없어요
네 이제 헤드셋 잘 들리세요?	이건 잘 들려요
숙박할게요	7만 원 결제 도와드릴게요
이용요금은 어떻게 돼요?	약되시면 최대로 할인을 했을 경우, 요금이 십팔만원이에요
세면도구, 샴푸나 린스?	다 있는데 칫솔만 가져오시면 돼요
프린터 사용할 수 있나요?	흑백은 장당 200원 칼라는 장당 500원입니다
레슨을 조금 받고 싶은데 가능한가요?	간단한 레슨은 무료로 해드려요
그럼 체크아웃 시간 오후 12시까지인가요?	오전 11시까지는 체크아웃 해주셔야 해요
예약자 신분증 주시겠어요?	대실 예약하신 거 확인되셨어요
노래방 말씀하시는 거예요?	노래방도 있어요
한 명당 얼마나 추가가 되나요?	한 명당 이만 원씩 추가돼요
객실 안에 무료 음료 어떤 게 제공되고 있나요?	저희는 음료수는 없고, 물은 사람 인원대로 제공되고 있어요
자장면 한 그릇, 짬뽕 한 그릇 배달시켜 주세요	알겠습니다
1박에 얼마에요?	넓은 방은 1박에 십만 원이에요
카드로 결제할 수 있나요?	결제하실 카드 주세요
펜션 독채는 마당도 쓸 수 있나요?	이용 가능해요
두 사람씩 두 팀이 묵을 방이 있나요?	두 팀 묵으실 방 있어요
10분에 얼마인가요?	2천 원입니다
라면 하나 삼각김밥도 주문해도 될까요?	감사합니다
가격은 날짜별에 다른데, 원하시는 날짜가 언제세요?	사월 삼일 일박 이일로요
여기는 1시간에 얼마 받나요?	좀 비싼 거 같네요
얼마 이상 충전하면 할인인가요?	12시간 충전 시 만 원입니다
결제는 카드로 할게요	카드 받았어요
방에 침대들은 다 있나요?	방마다 침대 두 개씩 있어요
당구 시간당 얼마인가요?	저희는 분당으로 계산됩니다
피시방에 이벤트라든지 이런 건 있을까요?	이벤트는 없습니다
여기 자리 있나요?	자리 많습니다
음식 주문도 혹시 자리에서 가능한가요?	자리에서 음식 주문 가능합니다
그릴에 불을 지피려고 하는데 숯은 어디 파나요?	캠핑장에서 따로 판매하고 있지는 않아요
혹시 계란 반숙 가능한가요?	원래 그냥 풀어서 드리는데 반숙으로 해드릴게요
입실은 언제부터 되나요?	4시부터 입실돼요
혹시 흡연실도 따로 마련이 되어있나요?	흡연구역이 따로 되어 있어요
세면도구는 칫솔까지 있나요?	칫솔은 없으면 드리는데, 가지고 오시면 좋아요
삼성페이로도 계산 가능한가요?	삼성페이로 계산 가능합니다
대실 가능한가요?	대실 가능하세요
11시보다 일찍 나가도 되죠?	그건 상관없어요
여기 현금결제만 되나요?	무인 충전기 사용 시 카드 결제도 가능합니다
한 객실당 가격이 얼마라고 했죠?	객실당 십오만 원이에요
어디서 오세요?	대구요
카드로 결제되는 건가요?	현금으로도 결제하실 수 있습니다
새로 회원가입하면 주는 혜택 있나요?	회원가입 혜택은 없고 매달 랜덤으로 한 분씩 열 시간 충전해드리는 이벤트 하고 있어요
녹차로 주세요	알겠습니다
혹시 주차장 있나요?	건물 지하 1층에 주차장 있습니다
숙박은 얼마인가요?	숙박은 1박에 4만 원이에요
지금 숙박 가능한 방이 있나요?	지금은 VIP 룸 밖에 없어요
여기는 1시간에 얼마 받나요?	임대료랑 최저임금 때문에 어쩔 수 없어요
동생이 청소년인데 제가 보호자 면 밤 열시 넘어도 사용 가능한가요?	청소년은 사용 불가능해서 나가주셔야 합니다
스위트룸 있나요?	몇 명이 투숙하나요?
청소는 해줘요?	요구 하시면 매일 해드릴게요
커피숍은 몇 시부터 몇 시까지 이용할 수 있나요?	커피숍은 아침 아홉 시부터 밤 열두 시까지 이용하실 수 있어요
거기 2박 연박 가능한가요?	가능해요
요즘 피파 이벤트 카드 하던데 진행하고 있나요?	피파 이벤트는 오늘부로 종료입니다
오늘만 숙박할게요	오늘 1박은 가능하세요
예약 가능한 날짜가 언제인가요?	원하시는 날짜를 말씀해주세요
사장님 오시면 당구 배울 수 있어요?	완전히 배울 순 없지만 대강 알려주시긴 해요
커플석 같은 거는 있어요?	커플석은 따로 없습니다
펜션에 다른 거는 없나요?	저희 과자, 과일은 무료로 드시면 되고, dvd 많고 웬만한 조미료도 다 있어요
계산은 혹시 카드도 가능한가요?	카드로 계산 가능합니다
바비큐장이 야외라서 지금 좀 춥지 않나요?	비닐이 다 쳐있고 저녁에는 난로에 불도 넣어드려서 그렇게 춥지는 않아요
현금 드릴게요	현금으로 결제해 드릴게요
네 그럼 먼저 음료수 좀 주세요	잠시만 기다리세요
성인 한 분 맞으시나요?	장비를 무료로 대여해 드려요
어떤 용품 말씀이신가요?	타월이나 룸에 구비되어 있는 물품들요
회원가입을 해야만 이용이 가능한가요?	비회원도 이용할 수 있습니다
조식이 포함된 가격인가요?	성인 두 분 조식만 포함된 가격이에요
요금은 한 시간에 얼마에요?	요금은 저희 비회원은 한 시간에 거의 1000원이에요
네, 인원이 몇 명인가요?	아이 한 명은 추가요금 있어요
네, 일회용품이 필요없으시면 빼드릴까요?	키 받으시고 705호로 가시면 돼요
칼라로 3장 뽑으려고 하는데요	여기 지정된 의자에 앉으시면 됩니다
저희가 따로 보관해 드리지는 않고 있는데, 어떤 것 때문에 그러세요?	혹시 보관을 해주시는지 여쭤보는 거예요
저희 4월 13일 주말, 1박 2일로 대인 2인이 이용하려는데 이용요금이 어떻게 되나요?	토요일이면 2인은 9만9천원이에요
연박할 경우에는 청소는 해주나요?	요청하시면 저희가 청소해 드려요
방은 조용해요?	저희 펜션은 조용한 편이에요
한 게임만 하려는 데 한 게임 다 가격은 어떻게 되나요?	1시간 미만 가격은 10분당 1500원입니다
죄송한데 커플석은 사용 못 하나요?	혼자 오신 분들이 무분별하게 이용하셔서 카운터에서 말씀 주시면 이용 가능하게 해드리고 있어요
계산은 카드로도 가능한가요?	카드로도 계산 가능합니다
계산은 카드로도 가능한가요?	카드로도 결제 가능하세요
1박 가격이 어떻게 됩니까?	1박에 8만 원이에요
카라반 이용시 요리는 어떻게 해 먹나요?	내부에 주방이 있지만 원하시면 야외에 모닥불과 그릴 제공해 드려요
치즈라면으로 주세요	10분 정도 걸립니다
결제는 나갈 때 하면 되나요?	사용하신 만큼 내주시면 됩니다
두 분이 각각 방을 쓰시나요?	방 2개 드릴게요
결제 삼성 파이로 되나요?	가능합니다
더블룸이나 트윈룸 중에서 어떤 방을 원하시나요?	더블룸으로 해주세요
성함이 어떻게 되세요?	김 예약이예요
결제 확인되셨고 오늘 숙박 맞으시죠?	숙박 맞아요
대인 한명이 온천 이용하려면 얼마에요?	온천 요금, 대인은 6천원이에요
조식도 신청했는데 확인해주실래요?	조식은 2층에서 7시부터 10시까지 이용 가능해요
삼성페이나 카카오페이도 결제 가능한가요?	삼성페이랑 카카오페이 결제 다 가능합니다
일주일 뒤 금 토요일은 예약 가능해요?	삼월 십일까지 만실이에요
체크인 도와주실래요?	안내해 드릴게요
키를 하나 더 받을 수 있나요?	하나 더 드릴게요
무인발급기 있나요?	무인발급기는 카운터 바로 옆쪽에 이용 가능합니다
2인실에 침대 하나를 더 놓으면 조금 좁더라도 연속으로 한 방을 쓰실 수 있는데, 그렇게 해드릴까요?	5월 1일부터 9일까지 예약되셨어요
메뉴 말씀드리면 시켜도 주시나요?	저희가 많이 이용하는 매장은 있어요
성함이 확인되지 않는데, 인터넷이나 전화 중 어느 것으로 예약하셨나요?	확인할 동안 잠시만 기다려 주세요
주말에 예약이 가능한가요?	여덟명이시면 첨성대 객실 하시면 돼요
네, 포켓볼도 있나요?	포켓볼은 없고 삼구, 사구는 있어요
체크아웃은 언제인가요?	체크아웃은 다음 날 열한 시예요
4명이 나란히 앉을 자리 있나요?	저쪽에 있습니다
몇 년 생이세요?	2인실 예약되어 있어요
한 객실당 금액은 어느 정도예요?	더블, 트윈 객실당 현장 가격이 십일만 이천 원이에요
여기 아까 주문한 라면 언제나 오나요	현재 준비 중입니다
음식 주문을 하려면 어떻게 해야 하나요?	컴퓨터에 음식 주문하기 버튼을 누르시면 메뉴가 뜨는데 음식을 고른 후 주문하기 버튼을 누르시면 돼요
숙박도 하실 건가요?	할 거예요
헬스장 이용 시간은 어떻게 되나요?	24시간 가능해요
한 가족 총 네 명이 이용하려고 하는데 이용요금은 얼마인가요?	분이시면 더블 디럭스 조식 포함 십오만 원이에요
여기 와이파이 있어요?	와이파이 키셔서 IPTIME 접속하시면 되세요
가까운 편의점이 어디 있어요?	정문으로 나가셔서 오른쪽으로 조금만 가시면 편의점이 있어요
자리 있어요?	30분 기다리셔야 해요
오후 세 시요?	오후 세 시요
룸에서 배달음식 시켜 먹을 수 있나요?	배달은 가능하고 주변에 식당들도 많아요
바비큐 7시에 부탁해도 되나요?	시간에 맞춰 준비해드릴게요
제휴 할인되는 카드 있나요?	제휴 할인 카드는 없고 조금 저렴하게 예약하시려면 인터넷 사이트로 하시는 편이 나아요
현금영수증 하시겠어요?	현금영수증 필요없어요
퇴실은 몇 시인가요?	낮 12시 이전까지 퇴실하셔야 해요
혹시 카드로 결제할 수 있나요?	카드로 결제하실 수 있어요
카드 결제나 현금 결제나 금액이 똑같나요?	똑같아요
인원이 총 몇 분이시죠?	3명입니다
그럼 결제 미리 할게요	결제 도와드릴게요
마세는 몇 점 이상부터 칠 수 있어요?	500 이상 칠 수 있습니다
네, 예약자분 성함이 어떻게 되시나요?	이지영입니다
물을 더 받을 수도 있나요?	물을 더 받으실 수도 있고, 칠층에 정수기도 있어요
오늘 숙박 가능합니까?	오늘 숙박 가능하세요
혹시 여기 피씨방 영업시간이 어떻게 됩니까?	24시간입니다
웰컴 드링크로 어떤 음료를 드시겠어요?	아이스 아메리카노로 주세요
카드 계산되나요?	가능해요
주중이에요, 주말이에요?	오월 오일부터 이박 삼일이요
세 시간 해놓고 중간에 30분 정도 나갔다 와도 되나요?	가능은 한데 시간은 더 드리지 않아요
대회 나가면 상금은 좀 많아요?	대회마다 달라요
네 그럼 그렇게 자리 주세요	5분만 기다려 주시면 자리 정리하고 안내해드릴게요
오늘 주무셔야 되죠?	다섯시 쯤 전화주세요. 사장님 그때 출근하시거든요
예약번호가 있는데 왜 이름이 없어요?	성함을 잘못 기재해서 이름으로는 찾을 수가 없었어요
12월 24일부터 26일까지 2박 3일 예약할 수 있을까요?	2박 예약 가능하세요
오 감사합니다 탄산음료 가져다주세요	가져다드릴게요
30분 추가하게 되면 얼마인가요?	1시간 이상 사용한 금액은 10분 기준으로 계산됩니다
몇 분 주무세요?	40만원이에요
예능프로그램 다시 보기 가능한가요?	직원에게 말씀해 주시면 연결해 드립니다
조식은 가능하죠?	조식은 비용을 따로 지불하셔야 해요
당구장 안에 커피 머신 있나요?	얼음도 있어서 차가운 음료 만들어서 드실 수 있어요
공항에 내려서 호텔까지 몇 분이나 걸리나요?	공항에서 호텔까지 차량으로 삼사십분 정도요
회원권이나 레슨은 있나요?	회원권과 당구 레슨 모두 준비되어있습니다
자동차 주차할 곳이 있나요?	3대까지 주차 가능해요
혹시 청소년들은 몇 시까지 이용할 수가 있나요?	청소년은 10시까지 이용할 수 있습니다
특실과 일반실 어디로 드릴까요?	거울 있는 특실로 주세요
주차가 가능한 곳도 있나요?	주차는 건물 뒤에 하시면 되세요
더블베드 룸과 가격 차이가 얼마나 나나요?	더블베드 룸은 1박에 60000원, 트윈베드 룸은 1박에 80000원이에요
공은 가져다주시나요?	공을 곧 가져가겠습니다
식사 배달시켜도 되나요?	여기 전단지 있어요
화장실이나 흡연실도 따로 구비가 되어있나요?	화장실이랑 흡연실 따로 구비되어 있습니다
그럼 회원가입을 해야 하나요?	비회원 이용도 가능합니다
이어폰에서 소리가 안 나서 교체해주세요	새 거 가져다드릴게요
현장 결제 가능한가요?	오셔서 현장 결제 하셔도 돼요
시트나 베개 지저분해서 교체 요청하면 갈아주시나요?	시트 교체 요청하시면 바꿔 드려요
요새 겨울이라서 바비큐를 하기 좀 힘들지는 않나요?	비닐하우스 다 쳐놔서 하우스 안에 들어가면 따뜻해요. 지난주부터 손님들 다 거기서 잡숫고 그래요
나중에 다시 전화를 드릴게요	전화 주세요
네 결제는 언제 하면 될까요?	나가실 때 결제해주세요
숙박 인원은 몇 명이신가요?	성인 5명에 아이 2명입니다
지금 4인실 밖에 없는데 괜찮으신가요?	괜찮습니다
컴퓨터 전원이 안 켜지는데 확인 부탁드려요	그 자리 말고 다른 자리 이용하세요
11번 자리 헤드셋이 안 들려요	헤드셋 전원 켜졌는지 확인해보시고 안되시면 바꿔드릴게요
세 명이 한 방에 숙박하시는 거죠?	방 하나 예약하려고요
침구류도 주시는 거죠?	침구류 드려요
안에 그릇이나 식기류 준비되어 있나요?	주방에 있는 서랍장 안에 준비되어 있어요
저희가 대구에서 가려고 하는데 시간이 얼마나 걸릴까요?	대구에서 오시려면 한 세시간이 걸려요
체크아웃은 몇 시인가요?	체크아웃은 열한 시까지에요
카카오페이나 삼성페이도 가능한가요?	카카오페이랑 삼성페이 둘 다 가능하세요
수용 인원 초과시 추가 요금 발생하나요?	인당 2만 원이에요
1층 전부 예약하신 분이신가요?	맞아요
계좌 이체로는 계산 가능한가요?	계좌이체로도 계산은 안 됩니다
갔다 올 때 먹을 거 사 와서 여기서 먹어도 되죠?	죄송하지만 그건 안될 거 같습니다
정액제로 바꿀 수 있나요?	바꿔드릴게요
예를 들어서 오월 사일쯤에 예약하면 얼마에요?	사월 말쯤에 조식 포함된 패키지 가격이 나오니까 일단 예약을 해두세요. 조식 패키지는 변경할 수 있고 조식 불포함 가격은 십삼만 육천 원이에요
혹시 음식 주문도 할 수 있어요?	자리에서 하실 수 있습니다
뷰가 좋은 방은 가격이 얼마죠?	1층은 18만 7천원이고, 2층은 21만7천원이에요
방에 샤워가운도 있나요?	2벌 준비되어 있어요
칫솔 치약 세면도구 필요하신가요?	그리고 수건도 2개 더 챙겨주세요
결제는 카드 되나요?	카드 결제 해드릴게요
음료 시키면 자리로 가져다주시나요?	화면에서 보시고 주문하시면 됩니다
바비큐는 몇 시에 해도 되나요?	5시부터니까 불러주세요
성인 두 명하고 학생 한 명 하고 삼인이 다 이용할 수 있나요?	저희는 다 오인 기준이라서 충분하실 거예요
삼월 이십오일 예약 가능한가요?	성인 두 분 일반 객실은 없고 스위트 객실로 디럭스 더블로 하셔야 해요
그러면 청소년들은 몇 시까지 사용이 가능한가요?	청소년들은 10시까지 사용 가능합니다
네, 몇 인분 필요하세요?	4인분이요
현금 결제도 가능한가요?	현금 결제 가능해요
오월 사일은 예약되나요?	오월 예약도 마찬가지로 원하시는 날짜부터 일주일 전에 회원분들 예약 끝나고 남는 객실 예약을 도와드릴 수 있어요
자작나무 8번 자리는 어디로 가면 될까요?	여기 방문자 센터에서 오른쪽으로 쭉 가시면 있어요
간단한 음식은 펜션에서 할 수 있나요?	간단한 음식은 펜션 내에서 취사 할 수 있어요
비상구랑 흡연실도 다 따로 있어요?	비상구랑 흡연실 다 있습니다
방 있어요?	있어요
주차 할수 있는 곳은 있나요?	건물 앞에 하시면 되는데 5시 반 이후로는 불가능하세요
기본적인 비품은 뭐가 비치되어 있어요?	다 있고 조미료하고 음식만 사 오시면 돼요
청소는 어떻게?	청소는 요청하시고 방을 비워주면 청소 아줌마가 가서 해 드릴거예요
짐은 맡길 수 있나요?	여기에 두시고 번호 키 받아 가세요
제가 가져온 종량제 봉투를 사용해도 되나요?	하지만 저희 쪽에서 처리해드릴 수 없기 때문에 가급적 지양해주세요
초크가 부족한데 더 주시겠어요?	여기 있습니다
결제는 카드 가능한가요?	카드 결제 가능하세요
추가적으로 필요하신 물품은 없으세요?	필요 없을 것 같아요
샴푸 비누는 채워주시나요?	1층 자판기에서 별도로 구매하셔야 해요
1박 묵으려고 하는데 방 있나요?	현재 싱글룸 이용 가능해요
네, 조식 서비스는 이용하시겠습니까?	결제 해드릴게요
온돌 방도 괜찮으세요?	이쪽으로 오세요
네, 김민지 씨 맞으시죠?	맞습니다
친구랑 2명이서 묵으려고 하는데  방 크기가 적당할까요?	2인실이라 방 크기는 적당해요
포켓볼도 있나요?	있습니다
욕실용품은 다 주시는거 맞나요?	맞아요
창가 쪽 방인가요?	바다가 보이는 방이에요
몇 명 묵으세요?	가족으로 4명이요
카카오페이는 현재 안 하고 있고 계좌이체는 가능하세요	계좌이체 해야 하는구나?
요금은 한 시간에 얼마인가요?	요금은 현금가하고 카드가하고 다릅니다
음료수는 어떤 거 주시나요?	탄산음료가 있습니다
바비큐 할 때 숯도 준비해주시나요?	식사시간 말씀해주시면 시간 맞춰서 세팅해드려요
어른 2명과 아이들인가요?	어른 2명과 아이 2명이에요
흡연실은 어디에 있나요?	흡연실은 저쪽에 있습니다
간단한 요리해 먹을 수 있나요?	취사시설이 있어요
인원이 몇 명이죠?	여섯 명 정도 가려고 하거든요
조식도 포함되나요?	7시에서 8시 사이 1층 식당에서 조식 이용 가능해요
오션뷰로 바꿔주실 수 없나요?	현재 오션뷰는 예약이 다 찬 상태라 죄송해요
네, 김철수 님 세분 예약하신 거 맞으세요?	1인 추가요금 15000원은 따로 결제해주셔야 해요
조금 할인해 주실수 없나요?	할인이 들어간 금액이에요
사장님 포켓볼 규칙이 어떻게 되나요?	띠가 있는 공과 띠가 없는 공으로 팀을 나눠서 구멍에다 넣으면 돼요
쓰레기는 어디에 버려야 하나요?	주차장 왼쪽에서 분리수거해주시면 돼요
언제쯤이면 방을 구할 수 있을까요?	한 시간 뒤에 다시 방문해 주세요
제가 오늘 예약을 했는데 확인해주시겠어요?	성함 말씀해주세요
아니면 펜션 하나를 통째로 빌리기는 건 어떠세요?	그럼 예약 진행해 드릴게요
연계된 렌터카 회사가 있나요?	렌터카는 아는 지인을 호텔 측에서 소개를 해주고 있어요
한 시간에 얼마죠?	한 시간에 1200원입니다
어떤 방들이 있나요?	특실과 일반실이 있어요
주문은 자리에서 하면 되죠?	메뉴 보고 주문해 주세요
체크인 시간은 몇 시인가요?	체크인 시간은 세 시에요
얼마나 숙박하시려고요?	2박 3일이요
오늘 날짜로 예약했는데, 확인 좀 부탁드려도 될까요?	방은 내 해드릴게요
5시간 먼저 계산할게요	2500원입니다
성인 사인 이용하시는 거예요?	중고생 두 명 있고 성인 두 명 있거든요
4구 치려는데 얼마인가요?	10분에 천 원입니다
지금 입실해도 돼요?	여기 키 드릴게요
그럼 저희 포켓볼 칠게요	자리 안내해드리겠습니다
카드는 한 시간에 천 원인가요?	카드는 한 시간 십분에 1000원이요
풀빌라 방은 얼마에요?	풀빌라 방은 이인 평일 기준 십오만원이고, 주말에는 이십구만원이에요
언제부터 묵으시나요?	오늘부터 삼일이요
네, 언제 예약하셨나요?	지난주 월요일에요
대실은 몇 시간인가요?	대실은 4시간이에요
방 하나에 퀸 침대 두 개 있는 데 괜찮으신가요?	아주 좋습니다
1박에 얼마입니까?	1박에 5만 원이에요
하루 식사비가 얼마예요?	한정식이랑 레스토랑이 있어서 메뉴에 따라 달라요. 한정식은 2만5천원부터 6만9천원까지고, 레스토랑 피자면 만8천원부터 2만3천원까지 있어요
PC 이용 가격이 어떻게 되나요?	1시간에 1000원입니다
이름이 뭐예요?	방금 넣어드렸어요
음료나 요리 주문은 어떻게 하면 되나요?	음료나 요리 주문 모두 컴퓨터에서 해주시면 됩니다
혹시 예약은 가능 할까요?	예약 가능합니다
한 게임에 얼마죠?	한 게임에 3000원입니다
숙박이신가요, 대실이신가요?	대실하실 방 있어요
네, 고객님 어떤 날짜 원하시나요?	4월 5일 금요일에는 1박은 가능하신데, 6일 토요일은 이미 마감되었어요
당구장 1시간 이용 요금 얼마인가요?	1시간에 8천 원입니다
혹시 포토샵 깔려 있는 자리 있나요?	죄송합니다만 포토샵은 없습니다
국제식 당구대 있나요?	대회용 당구대 있습니다
명 당 추가 비용은 얼마인가요?	1인당 만 원이에요
요금은 한 시간에 얼마네요?	한 시간에 1000원 입니다
총인원이 몇 분이에요?	총6명이에요
공휴일에도 다 영업하시는 건가요?	1년 365일 다 영업합니다
요번 주 토요일에 금액이 얼마쯤?	토요일이면 23만원이에요
자리에서 음식 주문할 수 있나요?	컴퓨터 상단에 주문하기 버튼을 누르시면 주문 가능합니다
당구장 몇 시 까지 영업하시나요?	오후 10시부터 새벽 4시까지 하고 있어요
저희 바비큐 하고 싶은데 지금 예약되나요?	알겠어요
지금 pc 자리 있나요?	자리 있습니다
리조트 내에 앉아서 쉴만한 카페 있을까요?	리조트 2층 울 상층으로 올라가시면 스타벅스가 있어요
흡연석은 실내에 있나요?	흡연은 금지되어 있습니다
1박 2일이면 얼마나 해요?	방마다 가격이 다른데, 9만원부터 13만원까지 있어요
6명 같이 앉을 수 있을까요?	최대 4명이 한 줄에 앉을 수 있어요
숙박은 1박에 얼마인가요?	1박에 50000원이에요
스위트룸으로 3일 묵으려는데 가격이 얼마나 되나요?	758000원이에요
와이파이는 다 설치가 되어 있나요	와이파이 있습니다
1시간에 얼마인가요	10분에 1500원 1시간에 7천 원이요
종목은 어떤게 있나요?	종목은 삼구하고 사구 있어요
2인실과 4인실로 가능해요	4인실로 해주세요
계산은 배달 오면 배달부에게 하는 거죠?	게임비만 저에게 내시면 됩니다
몇 분이세요?	3명이요
당구장에 주차는 어디서 해요?	지하에 주차장이 있어 편하게 하실 수 있으실 거에요
가능한데, 혹시 몇 명이세요?	아이까지 4명이에요
네 3명이요	8번 다이로 가시면 됩니다
신분증 대신 여권도 되나요?	신분증 대신 여권도 가능하세요
어떻게 이용하는 건가요?	머신에서 원하는 사용시간만큼 선결제하고 이용하시면 됩니다
몇 시까지 운영하나요?	24시간입니다
삼일 연박도 예약할 수 있죠?	금요일은 객실이 마감이고 토요일부터 가능하세요
흡연실도 따로 마련되어 있나요?	흡연실은 요즘 법이 강화되서 되어 있답니다
체크아웃은 몇 시까지인가요?	오전 11시예요
혹시 결제는 삼성페이나 카카오페이도 가능하신가요?	결제는 카카오페이는 안되고 삼성페이는 되세요
5월 20일 토요일에 예약 가능한 방 있을까요?	방 있어요
한판 치는데 얼마에요?	1시간에 인당 2천 원이고 10분씩 500원 추가요금 있어요
이렇게 두 명 왔는데 41번 42번 자리 이용하고 싶습니다	지금 잠금 풀어드릴 테니 가서 로그인하시면 됩니다
회원가입해야 하나요?	비회원으로 가능하세요
카드 결제되나요?	가능합니다
그럼 4구 공 주세요	자리에 가져다드리겠습니다
바비큐는 몇 시까지 이용 가능한가요?	저녁 9시까지 이용 가능해요
시간당 얼마인가요?	시간당 천 원입니다
식당 이용 시간이 몇 시부터 몇 시까지인가요?	식당은 아침 여섯 시 정도부터 새벽 두 시까지 영업해요
짜장면 2개 시켜 줄 수 있나요?	주문해드리겠습니다
예약 된 룸 몇 호예요?	502호예요
1시간에 얼마죠?	1000원입니다
어떤 라면 주문하시겠어요?	떡라면에 계란 추가 부탁드려요
아기도 조식 가격은 마찬가지인가요?	아이들도 오천 원이에요
칫솔이랑 기타 세면도구들 따로 구입해야 하나요?	세면도구 세트는 천 원에 구입하셔야 해요
확인 결과 두 호텔 예약 가능하신데 따로 원하시는 조건이 있으신가요?	위치가 공항과 가까운 편인 곳이요
지인분이랑 연락해보고 다시 전화드릴게요	전화 주세요, 감사합니다
뭐로 드시겠어요?	녹차 3잔요
돈가스 썰지 않고 주실 수 있나요?	가능합니다
스피커 키고 게임해도 되나요?	게임하실 때에는 헤드폰 꼭 착용해 주세요
바비큐에 기본적으로 제공되는 게 뭐가 있나요?	고기 구워 먹을 수 있게 불하고 숯만 준비해드려요
금연석 자리 있나요?	자리 많이 있어요
만 원어치 충전했는데 이제 그냥 사용하면 되나요?	자리에서 충전된 시간 동안 사용할 수 있습니다
일회용 양치 도구도 하나 더 주실 수 있나요?	1회용 세면도구는 1500원에 구매하셔야 해요
종일 요금도 있습니까?	있습니다
조금 있다가 다시 전화드리든지 할게요	전화 주세요
몇 분이서 이용 예정이신가요?	3인인데 어른 2명 어린아이 1명입니다
자체적으로 저렴한 다른 방은 없나요?	조망은 도심 방면이고 객실은 비좁으실 수도 있는데, 조금 저렴한 방은 있어요
음료는 뭘로 하시겠어요?	사이다 2개 콜라 2개로 주세요
그럼 1시간만 이용하면서 할게요	알겠습니다
혹시 여기 흡연 가능한가요?	죄송하지만, 이 건물은 금연구역입니다
외상 가능하나요?	아니요, 안됩니다
2인 기준 방에 3인 예약하려는데, 추가 금액은 얼마인가요?	1인당 1만 원이요
티브이가 안 나오는데 다른 방으로 바꿔주실래요?	다른 방으로 바꾸어 드릴게요
삼월 이십삼일 예약 가능한가요?	트윈 구조로 더블베드 하나, 싱글베드 하나 들어가 있고, 시내 전망 타입과 오션 전망 타입이 있어요
온돌과 침대방 중 어떤 걸로 해드릴까요?	침대방이요
음료는 어떤 게 있나요?	탄산음료는 기본으로 제공되고 따뜻한 커피 녹차 있어요
성함이 어떻게 되시죠?	금방자 입니다
저희 오늘 이 펜션에 예약했는데 체크인 좀 부탁드릴게요	여기 열쇠 있어요
지금 자리 있나요?	무인결제기 통해서 확인해보시는 게 빠르실 거예요
4명 가능한가요?	자리 있습니다
요금의 차이가 있어요?	비회원과 회원은 요금 차이가 있습니다
와이파이는 돼요?	와이파이 당연히 되어 있죠
그래도 소리가 안 나와요	잠시만 기다려주세요
10분에 가격은 얼마에요?	10분에 800원이에요
1층에서 7박 하시는 분이시죠?	120만 원이에요
묵게 되면 이용할 수 있는 다른 시설 같은 거 있나요?	지하에 간단한 놀이 시설 같은 게 있어요
강아지는 소형견인가요?	소형견이에요
학생들은 배우는 애들 많나요?	레슨 받는 학생은 한 명 있어요, 여학생
체크인 시간보다 2시간 전인데 안 될까요?	원칙에 따라야 해서 체크인이 불가능하세요
30분 일찍 체크인 가능한가요?	가능해요
객실 안에 전자레인지나 인덕션, 컴퓨터 같은 게 구비가 되어있나요?	컴퓨터는 없고, 인덕션이나 전자레인지를 쓰시려면 디럭스 트윈룸에는 없고 디럭스 콘도로 가셔야 해요
혹시 일행 와도 돈 추가 안 되나요?	일행 오셔도 추가는 안 돼요
혹시 비상구는 어느 쪽에 있어요?	비상구는 저 뒤쪽에 보시면 있습니다
삼성페이 이런 것도 가능한가요?	삼성페이는 안 됩니다
방법은 아시죠?	이쪽으로 오세요
방은 어떻게 준비해드릴까요?	죄송하지만, 방이 부족해서 모두 싱글 투 베드로 하긴 어려워요
와이파이는 있나요?	저희 펜션은 와이파이 돼요
라면 하나 부탁드릴게요	자리에 앉아서 주문하시면 됩니다
상관은 없으신데 몇 시쯤 도착 예정이신가요?	9시쯤 도착 예정입니다
호텔 편의시설은 어떤 것이 있나요?	호텔 일 층에 레스토랑, 어린이 도서관, 골프장, 지하에 노래방이 있고, 거기서 칠 분 정도 거리에 피트니스 장, 사우나가 있어요. 따로 비용이 발생하는 부분도 있어요
원래는 4명이 사는데 5명되면 추가가 되나요?	한 명 추가 돼요
이틀 숙박이 왜 안 되죠?	약이 꽉 차서 내일은 방이 없어요
예약자가 아직 안왔는데, 전화 말고 다른 예약 확인 방법은 없을까요?	직접 오시지 않는다면 전화로만 확인 가능해요
예약도 혹시 가능할까요?	예약은 안 됩니다
당구장 영업시간이 몇 시 까지에요?	24시간 영업하고 있어요
네 기본이 얼마나 되나요?	기본은 20분이에요
몇 분입니까?	4인 가족이요
뭐 음식같은 거는 주문할 수 있나요?	음식 주문하실 수 있습니다
체크아웃 몇 시에요?	체크아웃은 오후 열두시까지인데, 연장하실 수 있어요
인원 추가하면 가격이 얼마나 올라가나요?	4인 방 기준으로 한 사람당 15000원 추가돼요
공항까지 이용할 수 있는 셔틀버스 운영을 하시나요?	소규모 호텔이라 셔틀버스는 없어요
시간 설정은 어떻게 하죠?	당구대 때문에 불편하셨을 테니 10분 더 설정해서 20분으로 놓고 쓰세요
음료 중에 뭐가 제일 맛있어요?	아메리카노가 제일 많이 나가니까 제일 맛있겠죠
바비큐 2개 빌릴게요	2시간에 4만 원 선불이에요
혹시 삼성페이 되나요?	가능해요
학생 요금은 다른가요?	학생들은 한 시간에 6000원이에요
네, 몇 분이신가요?	둘이요
부가세는 별도인가요?	부가세는 별도로 받지 않습니다
김희성 고객님 대실 맞으신가요?	대실 맞습니다
쓰레기 봉지도 제공해주십니까?	저희 캠핑장은 제공해드려요
공항까지 거리 얼마 정도 걸리나요?	차량으로는 십오분 정도 소요돼요
할인되는 카드는 있나요?	할인 카드는 없어요. 지금 할인해서 십팔만 이천원이에요
화장실은 어디에 있나요?	밖으로 나가시면 있습니다
다음 주 토요일에 예약하고 싶은데요	약 되셨어요
아침 식사가 포함이 되나요?	아침에 빵하고 멸균 우유하고 잼을 드리면 방에서 구워 드시면 돼요
결재해주세요	카드 결제 도와드릴게요
바비큐장이 생각보다 좁네요. 한 테이블만 쓰나요?	4인 기준 한 테이블만 써요
네, 음료수는 뭘로 드릴까요	커피 주세요
객실 업그레이드되나요?	스위트룸으로 업그레이드 가능해요
네, 진달래방으로 예약하신 고객님 맞으시죠?	엊그제 예약했어요
음식 주문 가능한가요?	음식 주문 가능합니다
혹시 여기 음식 시켜먹을 수 있나요?	음식 시켜드시는 거는 안됩니다
언제 이용하실 건가요?	다음주 금요일 1박을 하려고 하는데요
수영장은 얼마인가요?	인당 만 오천 원이에요
날짜는 언제세요?	16일이나 17일 주말쯤 해서 갈려고 하는데
5장만 출력할게요	나갈 실 때 pc 이용요금이랑 같이 계산하시면 됩니다
컴퓨터 사양은 배틀그라운드 돌아갈 정도예요?	배틀그라운드 돌아갑니다
카드 결제 가능한가요?	하지만 현금으로 하시면 10% 할인해 드려요
아쉽군요 그럼 이용은 가능한가요?	가능합니다
세면도구도 샴푸, 린스 다 있나요?	바디샤워, 수건 있고 개인 칫솔, 먹는 물 가지고 오셔야 해요
인원 제한이 있나요?	당구대 하나에 5명 이상은 불가합니다
수영장 이용료는?	수영장 요금은 따로 없고 수영복은 입으셔야 해요
도보 기준인가요? 자가용 기준인가요?	차로 이동할 수 있는 기준이에요
삼월 이십삼일 예약 가능한가요?	디럭스 스위트 트윈이 기준 인원 삼인이라서 인원 추가 요금 만원, 침구 추가 요금 만원 결제하셔야 해요
청소년들은 몇 시까지 이용 가능한가요?	청소년들은 저녁 10시까지 이용 가능합니다
주말에 펜션 자리 있나요?	풀빌라 하나 빌릴 수 있어요
장갑 대여료는 무료인가요?	장갑 대여료는 한 시간에 천 원입니다
청소년들은 몇 시까지 사용이 가능한가요?	청소년들은 열 시까지 사용 가능합니다
와이파이는 설치 다 되어 있나요?	설치 되어 있고 비밀번호 없이도 사용 가능하세요
주방에 냄비가 있나요?	있어요
얼마나 기다려야 해요?	이십분 정도 기다리시면 될 것 같습니다
포켓볼 이용 요금은 얼마에요?	삼구랑 사구는 10분에 1300원이고 포켓볼은 1600원이에요
오버워치 pc방 이벤트 하나요?	지금 이벤트 기간입니다
지금 예약할 수 있나요?	가능해요
좀 더 늦게 나가도 되나요?	오후 2시에 체크아웃 하는 걸로 해드릴게요
이벤트가로는 평일에만 가능한가요?	평일만 해당되세요
예약하셨나요?	아닙니다
5월 5일 어린이날 예약하고 싶은데 방이 있을까요?	현재 룸 한 개가 남아있어요
예약한 사람인데, 확인 좀 해주세요	예약 확인 됐어요
이 근처 지도가 있나요?	호텔 출입구 앞에 지도 여러 종류가 구비되어 있어요
방에 있는 베드 사이즈는 뭐예요?	킹사이즈예요
인쇄를 하고 싶은데 가능한가요?	가능합니다
요금은 혹시 한 시간에 얼마인가요?	한 시간에 600원이에요
몇 분이 이용하실 건가요?	다섯 분 이용하시는 파티룸으로 예약해 드릴게요
숯이랑 고기는 저희가 준비해야 하는 건가요?	손님이 준비하셔도 되고 저희 바비큐 세트 구매하셔도 돼요
지금 바로 이용할 수 있나요?	바로 사용하실 수 있어요
정액제 발급받으려면 얼마에요?	만 원부터 있어요
흡연실도 다 만들어져 있어요?	흡연실 다 있습니다
DC 안 되면 얼마쯤 하죠?	DC 안 되고 6분이 들어가면 34만원이네요
청소년들은 몇 시까지 사용이 가능한가요?	청소년은 10시까지 사용 가능합니다
아저씨 사구 주세요	사구 준비해드리겠습니다
애완동물 데려가도 되나요?	애완동물은 저희가 반입 금지예요
시간당 얼마인가요?	한 게임당 5000원입니다
체크인 시간은 몇 시고 체크아웃 시간은 몇 시에요?	체크인 체크아웃은 저희가 상황에 따라서 조정을 해드리는데, 원래 체크인은 네 시고 체크아웃은 다음 날 열한 시에요
근처에 맛집 있나요?	마을 입구에 보면 식당은 많이 있어요
오버워치 깔려 있나요?	이용 가능합니다
요금은 얼마정도 하나요?	10분에 1300원이에요
객실 하나 이용하세요?	보통 다섯 분이면 스위트룸이 가장 적합해요. 침대는 퀸사이즈가 두 개 있고 거실이 있는데, 침구는 하나 저희가 무료로 제공해 드려요
확인되셨고, 1인실 맞으시죠?	그렇게 예약했습니다
모닥불은 피워도 되는 거죠?	모든 사이트 앞 흙 위에서 가능해요
침대는 한 개만 있으면 되시는 거죠?	일반실 하시면 될 것 같고 토요일은 주말 요금이라서 만 원 정도 더 비싸요
샤워 시설 마련돼있나요?	개인 샤워 시설 준비돼있어요
간식은 어떻게 주문하나요?	PC에서 주문 가능합니다
호텔과 연계된 렌터카 회사가 있나요?	저희가 호텔과 연계된 렌터카는 없지만 삼성 렌터카 통영지점을 추천해 드려요
한 명 더 같이 가게 되었는데, 추가가 가능한가요?	가능하신데, 스위트룸은 안되시고 룸을 업그레이드하셔야 하세요
네명 자도 상관없어예?	명 잘 방은 없어요
아이들이 몇 살이에요?	아이들은 다섯살, 여섯살이요
혹시 비상구는 어느 쪽에 있나요?	비상구는 저 뒤에 있습니다
음식이나 재료는 매점이 따로 있나요?	매점에서 고기나 다른 취사용 도구 구매 모두 가능해요
그럼 제 계정에 10000원 충전해주세요	앞에 있는 선불 충전 기계를 이용해주세요
객실 내에 세면도구는 있나요?	간단한 세면도구는 준비되어 있어요
공항까지 셔틀버스가 있나요?	저희 셔틀버스는 없어요
청소년들도 이용을 많이 하는 편인가요?	청소년 손님은 잘 없어요
몇 시 퇴실인가요?	낮 12시까지는 퇴실하셔야 해요
스위트룸은 얼마죠?	스위트룸은 1박에 8만 원이에요
재료는 저희가 준비하는 거예요?	숯불은 저희가 피워드리고 직접 구워 드시면 돼요
어디에 앉으면 되나요?	17번 자리를 이용하시면 됩니다
하룻밤만 묵으시는 건가요?	1박만 해요
차종은 어떻게 되세요?	소형차거든요
성함이 어떻게 되시나요?	김미나에요
혹시 학생 할인 있나요?	학생은 시간당 3000원입니다
조식 신청은 어떻게 하나요?	조식은 따로 만 원씩 추가돼요
네, 언제 이용하실 예정이신가요?	다음 주 금요일에 이용하려고요
얼마인가요?	11시부터 6시까지는 1인당 만 원으로 무제한 사용이 가능하십니다
청소년들은 몇 시까지 사용이 가능한가요?	밤 10시 전까지 사용 가능합니다
방이 몇 층인가요?	1층이에요
총 여섯 분 입실하시는 거예요?	합치면 여섯 명이요
숙박은 안 하고 잠깐 있다 갈 건데 얼마인가요?	대실은 3만 원이에요
네, 그걸로 결제해 주세요	잠시만요
20명 들어갈 방 있나요?	그렇게 큰 방은 없어요
호텔 편의시설은 뭐가 있나요?	헬스는 없고 샤워 시설은 다 되어 있어요
얼마죠?	2인실 1박에 7만 원이에요
내일 아침 7시에 모닝콜 가능할까요?	모닝콜 드릴게요
포토샵도 할 수 있어요?	포토샵 있습니다
카드로 결제할게요	카드 결제 해드릴게요
내일 저녁 6명으로 바베큐 예약해주세요	알겠습니다
문 여는 시간은 몇 시에요?	일찍 열면 12시이고 늦으면 1시에서 2시에요
택시 좀 불러주실래요?	로비에서 기다려주시면 안내드리겠습니다
사장님, 요즘도 사람들 예약 많이 해요?	주말은 많이 오시죠
호텔에서 가까운 공항까지 택시비가 얼마나 나올까요?	택시 타시면 만 오천 원 정도 나올 것으로 예상돼요
캠핑장 위치가 어떻게 되나요?	망상해수욕장 옆에 있어요
스위트룸 예약하면 조식은 주시나요?	조식 포함가격이에요
지금 칠 수 있나요?	오른쪽 자리 두 개 이용하세요
혹시 빈 방 있나요?	방 있어요
숯이랑 텐트 의자 빌리려면 어떻게 해야 하나요?	숯은 매점에서 구매 가능하고 텐트랑 의자 숯 그릴은 대여 가능해요
재떨이도 하나 주시고요	공공장소 흡연은 이제 금지입니다
숙박 가격은요?	숙박은 45000원이에요
언제부터 언제까지 영업하시나요?	여기는 24시간 영업합니다
이용요금 좀 깎아주실 수는 없나요?	저희가 토요일에는 할인이 없어요
인원이 몇 분이세요?	명이에요
대구에서 가려는데, 사월 십삼일 일박 이일로 예약하려고 하면 얼마인가요?	여섯 명 같으면 방 두 개에 토요일이라 십오만원이에요
몇 년 생이세요?	94년생입니다
포켓볼 당구대 있나요?	포켓볼은 구비되어 있지 않아요
시간당 얼마죠?	5천 원입니다
총 몇 분이 서 숙박하실 건가요?	2인 기준으로 한 명당 추가요금이 발생해요
포켓볼은 있나요?	포켓볼은 하나 있어요
몇 시까지 영업하나요?	24시간 영업하니 밤 새 즐기시기 바랍니다
화장실은 공용인가요?	여자 남자 따로 구별되어있어요
여기 와이파이는 설치되어있나요?	와이파이 설치되어 있습니다
남는 당구대 있나요?	20분 정도 기다리셔야 합니다
침대는 트윈인가요, 싱글인가요?	싱글베드 2개예요
처음 오셨으면 비회원이시고 성인이신가요?	성인입니다
성함이 어떻게 되시나요?	홍길동님 예약되셨어요
언제쯤 자리가 생길까요?	앞에 한 분 기다리는 분이 계셔서 조금 더 기다리셔야 돼요
현금은 얼마인가요?	현금은 한 시간 삼십분 해서 1000원 받고 있습니다
조금 고민해보고 다시 전화드릴게요	전화 주세요
3월 30일 1박 2일로 대인 2인, 예약 가능한가요?	3월 30일 성인 2명 예약 가능하세요
예약자분 성함이 어떻게 되시나요?	홍길동입니다
여기 실내에서 흡연 가능해요?	흡연실은 왼쪽에 있으니깐 그쪽으로 가서 흡연 부탁드려요
헬스장은 몇 시부터 이용이 가능한가요?	헬스장은 새벽 여섯 시부터 저녁 여섯 시까지 이용이 가능하세요
얼마인가요?	10만 원이에요
자동차 포함 카라반 이용 가능합니까?	자동차는 주차장에 세우시고 가능하십니다
성함이 어떻게 되시나요?	김 고객입니다
배달음식을 시켜 먹어도 가능한가요?	가능하지만 국물 있는 음식은 불가능합니다
장갑 빌릴 수 있을까요?	감사합니다
사구랑 포캣볼도 있나요?	포캣볼은 없어요
게임 시작 전 연습해도 될까요?	준비되면 시작 버튼을 누르세요
엑스트라 베드 추가 가능한가요?	엑스트라 베드 추가 가능하세요
계산은 어떻게 해야 하나요?	나가실 때 한 번에 하시면 됩니다
인원은 몇 명인가요?	어른 2명에 아이 1명입니다
전망이 좋은 층으로 예약하고 싶은데, 있나요?	10층부터는 전망이 좋아요
자리에서 음식도 주문 할 수 있을까요?	하지만 회원만 자리에서 음식 주문이 가능합니다
개인 큐대도 사용할 수 있나요?	개인 큐대는 안 되시고 하우스 큐대로 가능하세요
체크아웃은 몇 시까지인가요?	체크아웃은 오전 열한 시까지예요
네, 고객님 혹시 봐두신 객실이 따로 있으신가요?	바다가 보이는 디럭스 룸으로 예약하고 싶은데요
몇 점 정도 치세요?	대략 2000점 정도 칠 수 있어요
포카리 하나랑 사이다 하나요	라면이랑 음료수 결제 도와드렸습니다
요금은 어디서 충전해요?	여기 앞에 선불 충전기 있어요
대실은 얼마고 숙박은 얼마죠?	대실은 25000원이고 숙박은 60000원이에요
2명 묵을 방 있나요?	스탠더드룸은 공실이 없고 디럭스룸과 스위트룸 있어요
저희 바비큐 6시에 해주실래요?	6시까지 준비해드릴게요
비회원으로 하면 더 비싼가요?	회원가입하시면 더 저렴해요
식사 배달시켜도 되나요?	감사합니다
혹시 파티룸도 있을까요?	지금 파티룸은 1개 비어 있어요
체크인이 3시인데 얼리체크인 가능할까요?	현재 객실 준비 중으로 얼리체크인이 되지 않아요
체크인 시간이 어떻게 돼요?	체크인 시간은 삼 일 저녁 여섯 시 이후로 들어오시면 돼요
흡연 구역은 어디인가요?	화장실 옆에 흡연 부스 있습니다
호텔 수영장 이용 가능한가요?	투숙객에 한해 무료로 이용하실 수 있어요
성함이 어떻게 되시나요?	김종우로 예약했습니다
혹시 담배 냄새 안 나는 방 있나요?	직원에게 한 번 확인해 볼게요
10분에 얼마예요?	1500원입니다
저희가 두 명인데 옆자리로는 오래 걸릴까요?	10분 정도 더 걸릴 거 같아요
2일 예약하신 거 맞으시죠?	맞습니다
카카오페이가 가능한가요?	카카오페이는 안 하고 있어요
몇 시에 오시려고요?	3시에서 4시 쯤 될 것 같은데요
마트는 근처에 있나요?	차로 10분 정도 나가시면 하나로 마트 있어요
홍길동으로 2박 예약했는데, 확인 되나요?	2박 디럭스룸 예약 확인되었어요.
장기 투숙할 경우 계약서 작성이 가능한가요?	장기투숙 계약서 작성해 드려요
아침은 주나요?	저희는 조식 따로 없어요
주차할 수 있는 시설은 있어요?	주차장은 따로 없습니다
지금 pc 자리 있나요?	10번 자리로 가시면 됩니다
총 몇 분이 오시는 건가요?	5명입니다
삼월 구일 말씀하시는 건가요?	삼월 구일이요
한 시간에 얼마인가요?	인당 천 원입니다
객실 두 개를 하게 되면 추가 할인 같은 건 없나요?	죄송하지만 추가 할인 혜택을 진행하고 있지 않아요
아침에 몇 시에 나가야 해요	오전 10시까지 퇴실하셔야 해요
차 안 갖고 오세요?	차는 갖고 가려고 하고 있는데요
객실비 할인이 있나요?	지금은 할인이 되지 않아요
침대방으로 네 명 잘 수 있는 방 없어요?	침대방을 드려도 침대 위에서는 두 분 밖에 못 주무세요
이용요금은 인원수에 따라 비용이 달라지나요?	원래 4인 기준에 30만원이에요
특실로 방 하나 주세요?	특실은 1박에 9만 원이에요
삼성페이라든지 카카오페이도 가능해요?	페이결제도 가능하세요
파티룸은 일박 요금이 얼마죠?	저희 파티룸은 사인 자기에 딱 좋아요. 하루에 십오만 원인데 현금하면 십일만 원에 드릴게요
2명 자리 있나요?	이용 가능합니다
수건을 더 받을 수 있을까요?	수건 가져다드릴게요
3팀 이동하는데 준비물 뭐 챙겨 가면 되나요?	장비는 다 준비돼있어요 식재료만 있으면 돼요
수건이나 세면도구 다 구비되어 있나요?	수건이나 세면도구 있는데, 칫솔, 치약은 500원에 판매하고 있어요
조식은 주나요?	조식은 없어요
침대는 한 개만 있으면 되시는 거죠?	침대는 하나만 있으면 돼요
두 명 묵을거에요	2인실로 드릴게요
당구대가 총 몇 대인 가요?	8대 있습니다
아침 식사 할 곳 있나요?	청국장 집도 있고, 건너편에 김밥도 팔아요
체크아웃은 몇 시에요?	체크아웃은 다음 날 오전 열한 시까지예요
컬러로 10장 인쇄하려고 하는데 비용은 지금 지불하나요?	프린트 다 하시고 가실 때 한 번에 계산하시면 됩니다
와이파이도 설치가 되어있나요?	설치되어 있고 비밀번호 누르시고 사용하시면 돼요
이번 주 금요일, 삼월 일일 룸이 있나요?	삼월 일일은 만실이라 어려우세요
8층 가장 끝 객실이 조용한데 괜찮으신가요?	그럼 계산 먼저 해드릴게요
장갑은 어딨나요?	서랍 보시면 있을 거예요
캠핑장 온수도 나오나요?	정해진 시간에만 나와요
포켓볼 다이가 있나요?	2개의 다이가 있습니다
수영장은 있나요?	수영장은 여름에는 하는데 지금은 겨울이라 안 해요
몇 명이세요?	성인 둘입니다
조식은 얼마인가요?	어른은 2만 원 미취학 아동은 5천 원이에요
어떤 방으로 원하세요?	프리미엄 룸으로 주세요
객실 하나 필요하세요?	룸 하나요
주차할 수 있는 공간은 있을까요?	주차공간이 따로 있습니다
혹시 여기 배틀그라운드 다 돌아가요?	모든 좌석 다 돌아갑니다
카드 결제나 삼성페이 이런것도 다 가능한가요?	저희 가게는 카드기가 없어요
얼마죠?	4500원입니다
여기 근데 흡연도 가능한가요?	흡연은 1층 가셔서 해주세요
그러면 요금은 얼마가 되나요?	서비스 시간 제외하고 5천 원입니다
호텔에 편의시설이 있나요?	헬스장은 무료이고 사우나도 있는데 탕이 있는 사우나는 아니에요
저희가 자차로 가게 되면 발레파킹은 해주시나요?	발레파킹은 따로 없고 저희 지상 주차장에 직접 주차하셔야 해요
바비큐 예약한 거 확인 좀 해주실래요?	예약 처리되어 있어요
화장실 남녀 공용인가요?	아닙니다
다른 가격도 있어요?	중대는 1500원이에요
요금은 어떻게 계산하나요?	요금 충전기에서 선불로 요금 충전 후 이용 가능합니다
체크아웃은 몇 시에요?	다음 날 오전 열한 시에요
호텔마다 다른데 어느 여행지 호텔을 봐드릴까요?	제주도에 당일 예약 가능한 호텔로 봐 주세요
4구치려고 하는데 자리 있나요?	4구 자리는 없네요
회원가입을 해야지 이용이 가능한가요?	가입안하셔도 이용할 수 있어요
당구장 가봤나 봐요?	당구 좋아해요
가장 빨리 이용할 수 있는 날짜가 언젠가요?	4월 둘째 주부터 가능해요
카드 결제해주세요	카드결제 되셨어요, 201호로 가시면 돼요
금연 룸이 어디인가요?	왼쪽으로 들어가시면 됩니다
네 화장실 다녀온 후 라면 가지러 오겠습니다	곧 만들어 드리겠습니다
호텔 편의시설은 어떤 것들이 있나요?	저희 호텔 내에서는 온천 사우나, 헬스장이 있고 투숙객들은 팔천원에 이용이 가능하세요
2시간 결제해주세요	결제되었습니다
쿠폰 같은 건 없나요?	쿠폰은 하고 있지 않아요
청소년들은 몇 시까지 이용이 가능해요?	청소년들은 열 시부터 오후 열 시까지 가능합니다
시간당 얼마인가요?	천 원입니다
할인 카드는 없고, 날짜가 언제예요?	저희는 오월 초에 가려고 방을 좀 알아보는 중이거든요
캠핑장 이용하려는 빈자리가 있나요?	현재는 예약이 다 찬 상태에요
예약자분 성함이 어떻게 되시죠?	김동동입니다
혹시 자리에서 음식 주문 가능한가요?	주문하면 가능합니다
포켓볼 한 팀이랑 사구 한 팀 자리 있나요?	그렇게 하세요
여기서 제일 가까운 편의점이 어디예요?	앞쪽으로 50미터 정도 가시면 편의점 있어요
당구장 영업시간이 어떻게 되시나요?	오후 4시부터 열어요
시간당 얼마예요?	1500원입니다
근처에 볼만한 곳 있나요?	경주 오시면 구경할 곳은 많죠
조금 의논해보고 다시 전화 드릴게요	상의해보시고 다시 전화주세요
음료수 서비스 주나요	마음껏 드셔도 됩니다
네, 일회용품 필요하신가요?	여기 205호 방 열쇠 드릴게요
프린트할게 있는데 프린터기 이용할 수 있나요?	프린트기는 10번과 11번 자리에 배치되어 있습니다
흡연실 있나요?	안쪽으로 들어가시면 있어요
어떤 룸 원하세요?	고층으로 주시면 좋을 거 같아요
체크아웃은 몇 시에요?	체크아웃은 다음 날 열한 시에요
네 저희 기본 1시간이요	이후 추가 금액은 10분당 천 원입니다
룸서비스는 가능한가요?	룸서비스는 이용이 가능하시고, 객실 가시면 이용하실 수 있는 메뉴판이 있어요
사월 말쯤에 자리 있겠어요?	사이트에서 직접 예약하셔야 해요
언제 오시는데요?	이번주 토요일에 갔다가 월요일에 나오려고요
대구에서 가려고 하면 몇 시간 정도 걸리나요?	대구에서 저희 펜션까지 3시간 잡으면 돼요
컴퓨터 사양은 어떻게 돼요?	안쪽으로 들어가시면 고사양 게임 지정석이 따로 있습니다
공항까지 셔틀버스 운영하나요?	픽업은 없고 호텔에서 김포공항까지 차로 이십 분 정도 걸려요
카드 결제는 가능한가요?	가능해요
칫솔하고 치약 따로 구매해야 하나요?	칫솔치약세트는 천 원에 구매하셔야 해요
그럼 4시간 계산하겠습니다	4000원입니다
스파, 수영장도 이용할 수 있어요?	수영장은 별도로 이용요금이 있고 스파는 그냥 사용하시면 돼요
콜라부터 가져가도 돼요?	가능합니다
당구장에서 담배 피워도 되나요?	이제는 법이 바뀌어서 못합니다
네, 어떤 방으로 드릴까요?	더블룸으로 주세요
자리에서 음식도 주문 가능할까요?	자리에서 음식 주문 가능합니다
마트가 걸어서는 오래 걸리나요?	20분 정도 걸려요
엘리베이터는 어디에 있나요?	오른쪽 복도를 따라가시면 돼요
평일 몇 프로 할인 안 하나요?	평일은 방값도 싸고 숯불 정도는 서비스로 드릴게요
남편분 성함이 어떻게 되시나요?	홍길동인데 확인해 주시겠어요?
시간당 얼마인가요?	30분당 1000원씩 계산됩니다
조식은 포함되나요?	조식은 포함돼요
입실이 몇 시부터 가능하죠?	저희는 세 시부터 입실이 가능해요
레이트 체크아웃 가능한가요?	그럼 2시에 레이트 체크아웃 하는 걸로 해드릴게요
4월 6일 주말, 1박 2일로 이용하면 숙박비가 얼마인가요?	주말 2인이면 14만4천원이에요
몇 분이 주무실 건가요?	한 명씩 잘 건데 방이 2개 필요해서요
한 시간 더 추가 부탁해요	그럼 4만 원 결제할게요
대실은 몇 시간 이용 가능한가요?	대실 사용시간은 세 시간이에요
카드로 결제되나요?	또 모르는 거 있으시면 불러주세요
이용금액은 할인 안 되나요?	32만원이 할인된 금액이에요
객실 내에서 간단한 음식을 해먹을 수 있나요?	전기레인지와 간단한 식기도구가 준비되어 있어요
음식 주문은 가능한가요?	시키실 때 저에게 말씀해 주시면 주문 책자 드리겠습니다
헤드셋도 다 있나요?	헤드셋은 자리마다 다 있어요
룸서비스는 가능할까요?	룸서비스는 가능하세요
체크인은 몇 시쯤 하나요?	체크인은 세시에요
주차 할 곳은 있나요?	주차장은 건물에서 좀 떨어진 곳에 있어요
9시에 몇 분이세요?	3명 정도 올 거예요
네, 오션뷰 남은 방 있는데 몇 분이신가요?	2인이에요
주차장은 어떻게 이용하나요?	지하주차장을 이용하시면 돼요
혹시 비상구는 어느 쪽에 있나요?	저쪽이랑 뒤쪽 보시면 있습니다
계산은 카드로 가능한가요?	카드로 계산 가능하세요
여기 화장실이 어디죠?	당구장 자체 화장실은 없고 건물 화장실 이용하셔야 해요
네, 조식은 어떻게 하시겠어요?	조식도 같이 포함해주세요
현금영수증 해주세요	번호 입력해주세요
4명이서 2시간씩 칠게요	결제는 선불입니다
혹시 핫바도 파나요?	손님 뒤쪽에 있습니다
여기 배틀그라운드는 어느 자리에 깔려있나요?	전 좌석 가능합니다
픽업되나요?	저희 픽업은 안 돼요
체크인 시간이 어떻게 되나요?	체크인은 세 시에요. 조금 빨리 오신다고 하면 그 방은 먼저 청소를 해드려요
어떤 분 성함으로 예약해드릴까요?	홍길동으로 하겠습니다
포켓볼 테이블 있어요?	저 끝으로 가시면 됩니다
야놀자'에서 예약하는 것보다 전화로 예약하는 게 금액이 더 싸나요?	할인이 모든 업체 쪽으로 되어있는 상태라서 어느 쪽으로 예약을 하시든 금액은 똑같아요
인원이 몇 분이신가요?	가족 4명이거든요
비즈니스룸에 숙박 가능합니까?	비즈니스 룸은 만실이라 디럭스룸만 숙박이 가능해요
네, 몇 박 예약하셨나요?	2박 했어요
바비큐 하실 거예요?	재료구매 안 하고 그냥 갈 건데
1달 정액권 끊을 수 있나요?	1달에 5만 원입니다
체크아웃은 몇 시까지죠?	체크아웃은 12시까지에요
노래방 비용은 별도로 내야 하나요?	노래방은 한 시간에 만원이에요
연박하면 할인이 가능한가요?	연박하시면 숙박비가 할인돼요
배달은 되나요?	배달은 가능해요
음식은 어떻게 주문하나요?	컴퓨터로 주문과 계산하시면 저희가 가져다드립니다
전자레인지나 인덕션 컴퓨터 같은 거 있나요?	패밀리룸 같은 경우에는 컴퓨터는 있고 인덕션은 저희는 취사 금지예요
찾아가려고 하는데 위치 좀 알려주실래요?	인터넷에서 숙소 검색을 하시면 자세히 알려드려요
오실 분이 몇 분이세요?	총 여섯명이요
오월 초는 요금이 얼마나 되나요?	오월에는 조식, 온천 없이 십이만 육천 원이에요
오늘 예약한 김철수라고 하는데, 확인 해주실래요?	김철수 고객님 205호로 안내해드릴게요
카드로 하시겠어요?	결제 도와드릴게요
방 하나에 엑스트라 베드 추가해 주세요	베드가 추가될 동안 잠시만 기다려주세요
여기 방 일주일정도 사용할까 싶은데 하루에 얼마씩해요?	평일날은 이만원이에요
청소년들은 몇 시까지 이용이 가능한가요?	9시 59분까지 이용 가능합니다
여기 프린트 장당 얼마인가요?	흑백 프린트는 장당 200원이요
네 명 자는데 방은 침대에요, 온돌이에요?	방은 온돌이에요
당구장 내에서 흡연 가능한가요?	흡연실이 따로 있습니다
최대 한 방에 몇 명까지 들어갈 수 있죠?	4명이요
성인 2명과 어린이 3명이 들어갈 수 있는 방 있나요?	있어요
짜장면 배달도 되나요?	물론이죠
라면 하나 삼각김밥도 주문해도 될까요?	자리에 갖다 드릴게요
혹시 프린트되나요?	프린트됩니다
오늘 숙박하려는데 방이 있나요?	특실만 남아 있어요
성함이 어떻게 되시죠?	윤재영입니다
이 주위에 주차 가능한데 있나요?	주차는 건물 뒷편에 보시면 주차할 공간 있습니다
여기 포켓볼도 칠 수 있나요?	가능합니다
몇 분이신가요?	3명입니다
두 개 예약 시 할인되나요?	두 개를 하셔도 할인은 없어요
생수는 더 달라고 말씀드리면 받을 수는 있나요?	생수는 필요할 때 말씀해주시면 돼요
포켓볼은 얼마에요?	포켓볼은 10분에 1500원이에요
방은 어떻게 준비해드릴까요?	모두 싱글 투 베드 룸으로 예약하고 싶습니다
어떤 편의시설 말씀하시나요?	아이들이 이용할 수 있는 키즈카페라든지
장갑 있나요?	테이블 옆에 있습니다
기본요금에 왜 추가요금이 나왔나요?	유료 게임 이용하셨습니다
여섯 명 기준 방인가요?	아니요, 네 분이 기준이고 오월 추가 요금은 한 분당, 만 오천 원이라고 생각해주시면 돼요
다음 주 주말에 예약하려 하는데 방이 있나요?	바다가 보이는 방은 전부 예약되어서 일반 객실만 가능해요
와이파이는 되나요?	저희는 와이파이 돼요
주말에 디럭스룸 예약 가능할까요?	주말에 디럭스룸 예약 가능하세요
가격은 얼마인가요?	10만 원이에요
붙어 있는 자리인가요?	옆으로 나란히 붙어있는 자리입니다
체크아웃 늦게 해도 되나요?	정해진 시간에 나가셔야 해요
펜션에 특색 같은 거는 없나요?	홈페이지에 자세하게 안내가 되어 있으니 그쪽 보시면 돼요
사장님 혹시 여기 흡연실은 어디에 있나요?	흡연실은 저기 뒤에 있습니다
3시간이요	후불입니다
당구장에 짜장면 시켜 먹어도 될까요?	저희 가게에서는 외부 음식 반입을 금지합니다
몇 분이신가요?	총 다섯 명이 묵을 거예요
분리수거는 어디에서 하나요?	왼쪽 코너 옆에 분리수거장이 있어요
네 명 가려고 하는데 비품이 다 준비가 안 되나요?	저희는 비품이 이인 기준이에요
아이스 아메리카노도 같이 주문할 수 있나요?	가능합니다
그럼 저희 물 4잔만 갖다 주세요	알겠습니다
추가 인원 비용 얼마인지 알려주실 수 있나요?	주중과 주말에 따라 가격이 달라요
네, 오늘부터 2박 더블룸으로 예약 확인되셨고 금액은 20만 원이에요	카드로 결제해주세요
화장실 어디 있어요?	화장실 안쪽으로 가시면 있습니다
예약자가 아직 안 왔는데 괜찮은가요?	약하신 분께서 오셔야 하세요
네, 어떤 방을 원하시나요?	가족 네 명 이용할 방이요
13층으로 부탁 드려도 될까요?	여기 표에 이용하실 날짜 디너 뷔페 조식 칸에 체크해주세요
청소년은 혹시 몇 시 까지 이용이 가능한가요?	제한 없이 가능해요
이번 주말에 방이 있습니까?	명 지내실 방 하나 있어요
네, 몇 분이 묵으시지요?	저 포함 4명입니다
그럼 따로 흡연 장소가 있나요?	건물 밖에 흡연부스가 있습니다
컴퓨터 사양은 베틀그라운드같은 이런 거는 다 원활하게 돌아가나요?	베틀그라운드 할 수 있는 사양입니다
온돌 룸을 오늘부터 사흘 묵어도 똑같나요?	요금은 사흘 지내셔도 동일한데 오늘 온돌 룸은 만실이에요
숙박비에 조식도 포함이 되어 있나요?	숙박비에 포함되어 있지 않고 조식은 성인 기준 만 이천 원이에요
언제부터 지내실 예정인가요?	이번 주 토요일에 갔다가 월요일에 나오려고요
나중에 인원 더 올 예정인데 그건 이따 말씀드려도 되나요?	인원 추가에 대한 비용만 퇴실 시 지불해 주시면 돼요
음식 주문도 가능하구요?	저희는 음식도 다 셀프로 하고 있어요
욕실용품은 제공이 되나요?	어메니티는 무료로 제공이 가능한데 칫솔, 치약은 유료 제품이기에 별도로 챙겨오시는 게 나을 거예요
음료는 어디 있나요?	음료는 따로 주문하셔야 합니다
조식은 따로 예약 못했는데 추가 가능한가요?	조식 추가해드릴게요
이번 주 토요일 숙박이 가능한가요?	이인실에 네분 지내면 돼요
왜 이렇게 비싸요?	주말이라서 비싸요
다른 이용할 수 있는 편의시설도 있나요?	로비에 커피숍이 있어요
근처에 마트가 있나요?	오시는 길에 마트 하나 있어요
체크 아웃은 몇 시인가요?	11시예요
주말이세요?	주말이죠
일반 객실로 부탁할게요?	일반 객실 숙박은 6만 원이에요
조식은 미리 신청해야 하나요?	조식은 해당일 아침에 구입해주셔도 되세요
결제는 카드로 가능한가요?	가능합니다
바로 PC 키고 사용하면 되나요?	PC 키시고 여기 카드에 쓰여있는 번호 치시면 사용 바로 가능하십니다
오락실 요금은 지불해야 하는 건가요?	오락실 요금을 지불하셔야 해요
이번 주 토요일에 1박 예약 가능할까요?	현재 적정 인원 3인 최대 인원 5인실 예약 가능해요
바비큐는 당일 결제 가능한가요?	가능해요
현금영수증 되나요?	번호 찍어주세요
4월 14일에 2박 3일로 예약해주실래요?	예약비용은 만 원이에요
바다가 보이는 방이 있나요?	있어요
그 방으로 예약해주시겠습니까?	지금 예약해 드렸어요
성인은 10000원이고 초등학생은 6000원인데, 지금 티켓을 구매하실 건가요?	아침 6시부터 이용하실 수 있어요
편의시설 이용할 수 있는 게 있나요?	수영장, 사우나 시설 있고 별도 금액 지불하시고 이용 가능하세요
어디에 앉으면 되나요?	원하시는 곳에 앉으시면 됩니다
체크아웃 시간은 언제죠?	오전 10시예요
네 서비스 음료 뭐로 드릴까요?	커피 두 잔 두세요
편의시설은 어떤 게 있나요?	아침에 조식 드실 수 있으세요
여기 배틀그라운드 다 돌아가요?	전 좌석 다 돼요
인터넷에서 찾아보니까 바비큐장도 있던데 이용 가능할까요?	가능하고 초과 인원은 인당 만 원씩 지불해주시면 돼요
삼성페이 결제 가능한가요?	가능합니다
안녕하세요 시간당 얼마에요?	어서 오세요 시간단 5000원입니다
혹시 화장실은 어디에요?	화장실은 당구대 4번자리 오른쪽이에요
며칠 예약하실 건가요?	2박 3일 예약하려 합니다
호텔 1일 숙박하는데 얼마죠?	10만 원이에요
이름이 뭐예요?	김동현이요
몇 명이신가요?	2명입니다
커피숍이나 이런 건 전혀 없네요?	커피숍은 없어요
좀 불안한데 다른 화장실 이용할 수 있는 곳은 없나요?	그럼 이 근처 지하철역 안에 있는 화장실 이용하셔야 해요
한 10분에서 길면 20분 정도 기다리셔야 하는데 기다리시겠어요?	아 그럼 기다릴게요
몇 시까지 나가야 해요?	마감시간 새벽 4시입니다
방안 냉장고 음료는 무료입니까?	냉장고 안에 있는 음료는 무료로 드시면 돼요
지금 예약 가능한가요?	성수기 특별 할인 예약은 마감됐고 일반 예약 가능해요
큰 룸 하나로 없어요?	방에 침대가 한꺼번에 들어가 있어서 거실을 넓게 쓰는 스타일이 있어요
4인실로 예약하려는데 얼마 내야 해요?	4인실은 하루에 8만 원이에요
음료 뭐 뭐 있어요?	커피, 환타, 사이다, 콜라 있어요
카페는 몇 시에 문이 여나요?	오전 7시부터 오픈해요
2박 하고 싶은데 방 있나요?	방 있어요
회원가입을 해야지 이용 가능한가요?	비회원으로도 이용 가능하세요
종일 요금은 얼마입니까?	10000원입니다
음료수 공짜죠?	마음대로 가져가 드세요
저녁에 바비큐장 이용할 수 있나요?	6시부터 10까지 가능해요
포켓볼 다이 있어요?	여기서 하시면 됩니다
금액은 어떻게 돼요?	시간당 2천 원이요
체크인은 몇 시부터인가요?	체크인 시간은 따로 정해져 있지는 않아요
회원으로 등록하면 할인되나요?	회원 등록하시면 천 원에 20분 추가해드립니다
주변에 짜장면 맛있는 집 번호 아시나요?	이 집이 맛있는데 여기로 전화해보세요
샤워장이랑 화장실은 어디인가요?	샤워장은 1구역에 있고 화장실은 텐트 오른쪽에 있어요
몇 시부터 체크인 가능한가요?	오후 3시부터 가능해요
결제는 어떻게 하실 건가요?	약되셨어요, 예약자 성함 알려주세요
여기 회원가입을 해야지만 이용할 수 있나요?	회원가입을 하지 않더라도 이용할 수 있습니다
와이파이같은 경우는 다 설치되어 있나요?	와이파이 다 설치되어 있습니다
당구장에서 시켜 먹어도 상관없죠?	다른 사람들도 많이 시켜 드세요
네 저희 pc방은 이용해 보신 적 있나요?	처음인데 너무 오랜만에 pc방에 와서 생소하네요
네 어떤 공으로 드릴까요?	4구로 주세요
흡연실에 앉고 싶은데요	흡연실은 지금 자리가 없어요
후불로 하고 있어도 되나요?	자리에 PC예약 되어있는거 풀어드릴게요
커플석 있나요?	커플석은 따로 없어요
욕실은 하나잖아요?	욕실이 스파라 넓고 화장실도 따로 있어요
회원가입은 어떻게 해야하나요?	자리에 가서 컴퓨터 키시고 하시면 됩니다
3일간 숙박 시 할인이 가능합니까?	3일동안 숙박하시면 가격을 할인해드려요
PC방 영업시간이 언제까지 인가요?	저희 24시간 영업합니다
비회원도 사용이 가능한가요?	비회원도 사용 가능합니다
언제냐에 따라 다른데, 언제 오시는 건가요?	지금 집에 보일러가 고장 나서 애들하고 한 삼일 정도 묵어야 할 것 같아요
저희 오늘 캠핑 1박 예약했는데 확인 좀 해주실래요?	3번 텐트로 가시면 돼요
이 카드요?	들고 가세요
가격은 할인은 안되고예?	할인은 안 돼요
10분에 얼마입니까?	천 원입니다
세면도구는 따로 주시나요?	세면도구는 방 안에 비치되어 있어요
칫솔 치약 등 세면도구가 준비되어 있나요?	세면도구는 준비되어 있어요
근처에 갈만한 곳은?	엑스포장에 아쿠아리움도 있어요. 해상 케이블카 타는 곳, 오동도 다 10분 거리 안에 있어요
참 밖에서 가져온 이 음료수를 여기서 마셔도 되나요?	당구대 근처에서는 조심해주세요
흡연구역은 따로 있나요?	흡연구역 있습니다
사장님 당구장에서 음식 시켜먹어도 되나요?	시켜 먹어도 상관없어요
키가 져 가야 되나요?	열려있습니다
간단하게 해 먹을 수 있는 전자레인지가 구비되어 있나요?	전자레인지는 구비되어 있고 편의점을 이용하셔도 돼요
자리 하나에 헤드셋이 없는데요?	왼쪽에 헤드셋 하나 가져가셔서 사용하시면 됩니다
커플 PC로 예약하신 것 맞으신가요?	약 확인 되셨어요. 키 드릴게요
금액은 얼마인가요?	1시간에 5천 원입니다
주류도 반입이 가능한가요?	원하시면 술도 가능합니다
엑셀로 자료를 뽑으려면 시간당 제가 돈을 드려야 되나요?	근데 지금 잉크가 없어서 출력이 안돼요
예약자 성함이 어떻게 되세요?	김철수입니다
추가 베드 신청 가능한가요?	간이침대로 제공되고 추가요금이 있어요
호텔 내 와이파이가 무료인가요?	무료로 와이파이 이용 가능해요
회원가입을 할 수 있나요?	원하는 자리에서 회원가입을 진행하시면 됩니다
음료수 서비스인가요	직접 가져다 드시면 됩니다
그럼 메뉴 좀 보여주세요	자리에서 화면으로 주문하시면 됩니다
여기도 체인점이죠?	체인점입니다
룸 안에서 음식을 배달해서 먹을 수는 있나요?	배달은 해 드시면 돼요
한 장당 얼마죠?	한 장에 300원입니다
추가요금 내고 퇴실 시간을 늦출 수 있을까요?	미리 말씀해주시면 1시간 정도는 추가요금 없이 연장해드려요
예약했는데, 확인 좀 해주실래요?	김기동 고객님 패밀리룸 예약이세요
퇴실은 몇 시까지인가요?	내일 낮 12시까지 퇴실하셔야 해요
계산은 혹시 카드도 가능한가요?	카드로 계산 가능합니다
포켓볼로 하겠습니다	자리 안내해드리겠습니다
음식 주문은 어떻게 하나요?	카운터에 직접 하셔도 되고 자리에서 주문하셔도 됩니다
픽업하는 차는 없죠?	저희가 픽업을 나가요
주차 할 공간은 있나요?	밑에 있는데 차가 만차 상태일거에요
주차 장소는 따로 있나요?	펜션 사용하시는 고객들은 모두 무료주차 가능하세요
결제할 때 카카오 페이가 가능한가요?	저희 호텔에서는 따로 카카오 페이와 연동되어있지 않아요
삼인이 묵을 수 있는 방으로 얼마에요?	삼인이시면 기본적으로 이십평짜리 방, 주말 가격 적용하면 십오만 삼천원이에요
어느 앱으로 예약하셨나요?	야 놀자요
주차공간은 충분하겠죠?	걱정 안 하셔도 돼요
체크아웃 시간은 몇 시인가요?	다음 날 열한 시까지 나가시면 돼요
후불도 가능한가요?	후불은 안되고 선불만 가능하세요
여기 회원제랑 비회원제 요금 차이가 심한가요?	시간당 200원 정도 차이 납니다
한 시간에 얼마죠?	1시간에 2000원입니다
여기서 짜장면 배달해 먹을 수 있을까요?	가능합니다
수영장은 없죠?	수영장은 없어요
포켓볼 치다가 4구로 변경 가능할까요?	가능합니다
3월 중순, 주말인가요?	3월 중순 주말이요
짜장면 배달되죠?	됩니다
5명 가족이 사용할 수 있는 방이 있나요?	5명 사용할 방이 준비되어 있어요
몇 살인가요?	16살은 추가비용이 필요해요
4인실은 얼마인가요?	4인실은 1박에 9만원이에요
포켓볼 있나요?	2대 있습니다
여기 음식 해먹으려면 어디로 가야 돼요?	쭉 가셔서 오른쪽에 취사장이라고 적혀있는 곳에서 식사하시면 돼요
커플석은 요금이 다른가요?	1인당 500원 추가됩니다
여기 초크 새 걸로 갈아주시겠어요?	새 초크 가져다드리겠습니다
그리고 콜라와 라면 주문할게요	잠시만 기다려 주세요
부가시설이 없어요?	부가시설은 없어요. 통영 호텔 이용하시는 분들은 시장 중심이나 여객선 터미널에 밀접해 있어서, 이 근처에서 뭔가를 하려고 하시지 호텔 안에서 뭔가 하시려는 분들은 없다고 봐야 해요
포켓볼 대가 있나요?	제일 끝 쪽에 한자리가 있습니다
인원은 몇 명이시죠?	성인 2명, 아이 1명입니다
조식도 되나요?	조식은 추가해주시면 되시는데 성인 한 분당 이만 삼천 원, 소아는 만 이천 원이에요
드라이기와 고데기가 준비돼 있을까요?	드라이기만 준비되어 있어요
독채 가격은 얼마 하나요?	1박에 32만 원이에요
회원가입을 해야지만 이용이 가능할까요?	비회원도 되고 회원도 이용 가능합니다
방갈로 사용 가능한가요?	가능해요
주변에 괜찮은 식당이 있을까요?	이 근방에 유명한 고깃집이 길 건너에 있어요
영수증 필요하신가요?	영수증은 괜찮습니다
저기 맞은편 빈자리 앉을 수 있나요?	저기서 플레이하세요
몇 분이세요?	명입니다
공항에서 호텔까지 택시 요금이 얼마쯤 나오나요?	택시 요금이 정확히는 잘 모르지만 만 원에서 만 오천 원 정도 나올 거예요
인피니티 풀이 용도 체크인 이후에 사용 가능한가요?	체크인 이후부터 체크아웃 이전까지 사용 가능해요
청소년은 몇 시까지 이용 가능하죠?	밤 10시까지입니다
와이파이같은 경우는 설치가 되어 있나요?	와이파이 설치되어 있습니다
모닝콜 부탁드려도 될까요?	시간 알려주시면 모닝콜 해드려요
그러면 짜장면 두 개 주문 부탁드립니다	도착하면 테이블로 가져다드릴게요
몇 분 묵으실 건가요?	2명입니다
방은 몇 개 필요하세요?	방은 2개로 나누어서 가능할까요?
바비큐 장비도 빌릴 수 있나요?	빌릴 수 있어요
간단한 음식은 저희가 조리해 먹을 수 있나요?	기본적인 취사도구 다 세팅되어 있어요
기본 금액에 포함 인원이 몇 명인가요?	4명이에요
3일치 숙박비와 추가 금액 총 합해서 얼마입니까?	숙박비와 추가비용 합하시면 총 153000원이에요
대구에서 가는데 자차로 이동하는 게 낫나요? 공항을 이용하는 게 낫나요?	차로 오시는 게 훨씬 낫죠
4명인데 붙어있는 자리 있나요?	당장은 4자리 붙어있는 곳은 없습니다
카카오페이나 삼성페이도 가능한가요?	카카오페이나 삼성페이도 계산 가능합니다
몇 시에 입실이 되나요?	오후 5시부터 입실 하실 수 있어요
카드 되나요?	됩니다
배그 돌아가나요?	배그 됩니다
그럼 커피 1개 환타 1개 주세요	조금만 기다려주세요
수건 추가로 받을 수 있나요?	준비해서 방으로 가져다드리겠습니다
그럼 30분쯤 후에 짜장면 3개 부탁합니다	주문해 드리겠습니다
언제부터 묵으실 계획이세요?	잠시만요, 확인해 볼게요
어떤 방으로 드릴까요?	배그 피씨 있는 방이요
혹시 음식도 주문을 할 수 있나요?	음식 주문도 할 수 있습니다
와이파이는 설치가 되어 있나요?	와이파이 설치되어 있습니다
야외는 바닷가라서 춥지 않나요?	비닐도 쳐놓고 난로도 피워 드려요
음식은 여기서 주문하고 가야 해요?	자리에서도 가능하십니다
배달음식 주문 가능한가요	카운터에 얘기하면 배달 가능합니다
출근하시는 거예요?	출근 다 하고.
어린이랑 성인이 추가 가격이 똑같나요?	동일해요
저희 아이스티 하나씩만 빨리 주세요	바로 갖다 드릴게요
룸에서 배달음식 시켜 먹어도 되나요?	저희 호텔 객실은 따로 배달 이용이 안 되세요
초크 가져다주세요	테이블로 가져다 들겠습니다
조식 비는 따로 없나요?	조식은 서비스 차원으로 드려요
아무거나 사용해도 되나요?	비어 있는 자리 이용하시면 됩니다
주차 할 공간은 있나요?	밖에 보시면 주차타워가 있습니다
더블 객실이랑 트윈 객실 두 가지 다 안내해 드릴까요?	더블이랑 트윈 가격이요
바비큐 불은 어떻게 끄나요?	물을 부어 꺼주세요
컬러 프린트는 장당 얼마에요?	컬러 프린트는 장당 500원이에요
여기 와이파이는 다 설치되어 있나요?	와이파이는 다 있어요
혹시 취소하는 분들도 있을 거 아니에요?	저희가 취소하는 분들이 있다고 해서 고객님들께 일일이 연락을 드리기는 어렵고 고객님께서 저희 쪽으로 문의를 해주시는 방법밖에는 지금 없으세요
방에서 담배 냄새가 심해요. 비싼 돈 냈는데 서비스가 이러면 어떻게 합니까?	아래층에 계신 손님이 흡연하셔서 바로 주의 드렸어요
오늘 아니시죠?	다음 주 토요일이요
동궁 식물원이라고 아세요?	차 타고 갈 건데요
포켓볼을 할 수 있나요?	중앙에 하나 있습니다
롯데카드 할인 혜택 있나요?	롯데카드 할인 혜택은 따로 없어요
당구대 자리 있나요	있습니다
자리 있나요?	저쪽 끝 한자리 있습니다
흡연은 어디서 하나요?	흡연실이 따로 있어서 문 잘 닫고 이용하시면 돼요
차는 가져가야 하죠?	차를 안 가지고 버스 타고 들어오시면 펜션까지 저희가 태워 드려요
예약확인 할 때 이름 외 다른 것은 필요 없나요?	약 때 결제할 때 입력하신 카드번호 필요해요
장작은 파나요?	한 자루에 만 오천 원씩 구매 가능해요
세면대랑 샤워실도 그냥 쓰면 되나요?	자유롭게 이용하시면 돼요
여기가 숲속 펜션 맞죠?	방 준비해 뒀습니다
여기 피씨방 영업시간이 어떻게 돼요?	피씨방은 24시간입니다
추가 요금은 얼마인가요?	베드 하나 당 3000원이에요
사장님, 물티슈 한 개만 주실래요?	물티슈 두고 쓰시게 하나 가져다 드릴게요
시간당 얼마에요?	10분에 2천 원 정도라고 생각하시면 돼요
와이파이도 되나요?	와이파이 비밀번호는 방 열쇠에 적혀있어요
시간에 얼마인가요?	시간에 600원입니다
자리 있나요?	있습니다
프린트 비용은 얼마인가요?	한 장에 50원입니다
혹시 커플석 같은 것도 있나요?	커플석은 없습니다
조금 더 이르게는 안될까요?	시쯤 해서 삼 박으로 해드릴게요
룸서비스는 몇 시까지 이용 가능합니까?	11시까지 이용 가능해요
계좌 이체 되나요?	계좌번호 문자로 넣어드릴게요
차량도 다 이용 가능한가요?	차는 갖고 오시는 게 제일 편리해요
대실 좀 하려고요	대실은 3만 원이에요
몇 분이 이용하시나요?	총 5명입니다
그럼 하고 싶은 만큼 다 치고 후불로 결제하면 되는 거죠?	편하실 대로 하시면 돼요
오늘 예약했는데요?	확인되셨어요
당구장 지금 자리 있나요?	두 자리 남아있습니다
수영 타월은 따로 받을 수 있나요?	룸 키를 부스에 보여주시면 그냥 제공해드리고 있어요
혹시 예약같은 거도 가능할까요?	예약도 가능합니다
룸에서 배달음식 시켜서 먹어도 되나요?	배달음식 시켜 드셔도 돼요
공휴일에도 영업하시나요?	사정이 있지 않는 이상 공휴일에도 영업해요
5일 동안 머무를 예정인데 방 종류는 어떤 게 있나요?	디럭스룸과 로열룸 그리고 프리미엄룸이 있어요
한 시간에 얼마를 하나요?	천오백 원입니다
내일 몇 시까지 퇴실해야 되나요?	내일 오후 1시까지 해주시면 돼요
여자 화장실은 어디 있나요?	입구 좌측 편에 있습니다
귀중품 같은 거는 따로 보관을 해주나요?	귀중품은 따로 보관 안 해 드려요
사구랑 삼구랑 포켓볼 이렇게 다 있나요?	다 하실 수 있게 되어 있어요
예약을 안하고 왔는데, 지금 할 수 있나요?	마침 캔슬된 방이 있어요
게임은 어떤게 있나요?	삼구하고 사구하고 포켓볼 이렇게 있어요
체크인 부탁드려요	성함 말씀해주세요
피씨방 영업시간이 어떻게 되나요?	24시간 영업입니다
싱글베드 2개 있는 방으로 바꿔주실 수 있나요?	죄송하지만 현재 방이다 차있어서 바꿔드리기 힘들겠네요
요즘은 컴퓨터로 주문하는데 자리에 앉으셔서 한번 보시고 주문해주세요	컴퓨터로 주문하다니 신기하네요
바비큐 하면 비용이 추가되나요?	바비큐 비용은 이만원인데 만 원만 받을게요
얼마나 추가하면 되나요?	3만 원 더 결제하시면 숙박으로 바꾸실 수 있어요
배달 음식 추천 좀 해주세요	보통 중국집 많이 찾으세요
결제할 때 제휴 할인 카드가 있나요?	제휴 할인 카드는 없어요
바비큐장 사용할 수 있나요?	바비큐장이 방문 앞에 있어 바로 하실 수 있어요
오늘 숙박 가능한가요?	숙박 가능하세요
그럼 요금은 한 시간에 얼마 정도 나오나요?	회원 기준으로 600원입니다
무인결제기 사용 방법을 모르는데 도와주실 수 있나요?	가능합니다
흡연실도 따로 다 마련이 되어있으시고?	흡연실 외는 금역구역입니다
바비큐 고기류나 이런 거는 준비해서 가야 하는 거죠?	바비큐 하시게 되면은 이용료는 만원이에요
이불이나 베개는 추가로 더 주실 수 있는 거죠?	이불, 베개는 깨끗한 거로 준비해드려요
한 시간에 얼마에요?	1500원입니다
아이들 침구류는 깔끔한가요?	침구는 깔끔하게 해드려요
차 타고 가려고 하는데 주차할 수 있죠?	가능해요
혹시 원하시는 방이 있으신가요?	바다가 잘 보이는 방은 주말이라 없어요
네, 몇 분 정도 숙박하실 예정이신가요?	그럼 더블 침대 2개 있는 방으로 안내해드릴게요
호텔 예약 하려고 하는데 도와주실래요?	1월 1일 2박 예약 가능해요
이벤트 있나요?	이벤트 신청하시면 비용이 발생해요
내일 조식은 몇 시부터 몇 시까지인가요?	7시부터 10시까지 이용 가능해요
집이 일이 있어서 이사랑 안맞아서 장기로 7에서 10일정도 가족이 3명정도 묵을 방이 있나요?	3명 묵으시지만 4인 기준요금이에요
더 필요한 건 없으세요?	방에 치약이랑 수건이 모자랍니다
여기 PC방 영업시간이 몇 시까지에요?	저희는 24시간 영업해요
신분증 확인 가능할까요?	약되어 있으시네요
룸에서 배달음식 시켜 먹을 수 있나요?	배달음식 가능하시고, 객실 호수 말씀해주시면 바로 배달돼요
커피숍 이용은 몇 시부터 몇 시까지 이용할 수 있나요?	커피숍 오픈은 열시 정도에 하고, 열시에서 열한시 사이에 닫아요
배고파서 배달음식 주문하려는데 괜찮은가요?	번호 알려드릴게요
바비큐장은 어디 있나요?	내려가셔서 우측에 보이는 하우스 천막 안에 있어요
다른 데 알아보고 계시는 거예요?	쪼매라도 싼데 며칠 있을까 싶어서
결제는 계좌이체가 가능한가요?	가능해요. 계좌번호 드릴게요
여기 혹시 카카오페이 되나요?	카카오페이 결제 가능하세요
얼마에요	흑백은 장당 300원에요
6명 가능한가요?	어서 오세요
사장님 너무 더운데 히터 꺼주시겠어요?	히터 옆에 리모컨으로 끄시면 되세요
자리는 아무 데나 앉으면 되나요?	원하는 자리에 앉으세요
여기 흡연실 어디있어요?	흡연실은 저기 있습니다
4인 가족 3박  예약하신 거 맞으시죠?	맞습니다
저녁 때는 저렇게 다이 빈 다이도 없겠네요?	그렇죠, 근데 당구장 어딜 가나 다 그래요.
근처에 마트가 있나요?	큰길로 나가셔서 500미터만 올라가시면 홈플러스가 있어요
가격이 어떻게 되나요?	시간당 2500원입니다
캠핑장 이용하시는 거 맞으시죠?	맞습니다
그리고 컴퓨터가 안 켜지는데 확인 부탁드려요	필요하신 거 있으면 자유롭게 문의해주세요
PDF 뷰어가 필요한데 컴퓨터에 설치되어있나요?	필요하시면 체험판을 설치해드릴게요
각각의 방 가격을 알려주실래요?	디럭스룸는 5만 원 로열룸은 10만 원 프리미엄룸은 15만 원이에요
게임 종목은 어떤게 있나요?	사구하고 삼구, 포켓볼 3대 있어요
성함이 어떻게 되세요?	김기동입니다
몇 시에 준비해드릴까요?	그때 방으로 갖다 드릴게요
여기서 가장 저렴한 방은 1박에 얼마인가요?	2인실 기준 85000원이에요
닉네임이 어떻게 되시죠?	허철구입니다
아기들 이용할 수 있는 놀이 공간은 있나요?	놀이 공간은 따로 없어요
체크아웃 시간은 몇 시인가요?	체크아웃 시간은 낮 12시에요
평일은 얼마쯤 해요?	평일은 주말보다 4만원 저렴해요
침대는 트윈침대랑 더블침대 중 어느 것으로 할까요?	더블침대로 2개 준비해주세요
산호 룸은 육만 구천 원, 가격이 맞나요?	육만 구천 원은 평일 가격이고 주말이나 어린이날은 더 비싸요. 두 명 기준이에요
후불로 이용해도 되나요?	후불로 이용해도 되세요
세면도구 같은 거는 다 구비가 되어 있나요?	샴푸, 린스도 구비되어 있고 손님은 칫솔, 면도기 준비해오면 돼요
총 몇 분이 이용하실 건가요?	성인 2명에 어린이 2명입니다
방은 따뜻한가요?	방은 걱정하지 마세요, 위에 밑에 다 따뜻해요
가족하고 의논해서 전화 다시 드릴게요	전화 주세요
네, 고객님 숙박하시는 날짜가 어떻게 되세요?	3월 15일에서 16일까지 1박이요
1박에 얼마인가요?	2만 원이에요
침대방에도 온돌로 되어 있어요?	침대방 바닥이 온돌이에요
몇 분이신가요?	두 명요
회원과 비회원 가격 차이가 있나요?	회원으로 하실 경우 조금 더 쌉니다
바비큐 장비 한 세트 빌릴 수 있을까요?	여기 있어요
이용할 수 있는 특별한 공간이 있나요?	개별 테라스하고 탁구, 당구 4구, 포켓볼, 족구장, 골프, 노래방, 이 정도 있어요
아니요 어떤 걸로 하시겠어요?	커피 2잔 주스 2잔 주세요
펜션에서는 대게 취급을 안 하세요?	저희 지금 대게는 판매 안 해요
재떨이 좀 주세요	여기 있습니다
네, 몇 분이 이용하시나요?	성인 4명입니다
음료는 안 필요하세요?	맥주 2병 주세요
짜장면 2개 카드 결제할게요	잠시만요
여기 입장료 얼마에요?	대인 1명 9000원입니다
네, 현금으로 결제하시나요?	카드로 결제하고 싶습니다
나중에 1명 더 오면 추가 비용 있나요?	1인당 추가 비용은 15000원이에요
결제하면 바로 입실 가능한 거죠?	지금 대기인원이 있어서 입실하시려면 조금 기다리셔야 해요
프린트되나요?	가능합니다
3일 250000원짜리 방 있는데 이건 어떠세요?	그거로 예약해주세요
여기 주차장 사용할 수 있죠?	주차장 이용 가능하세요
침대방과 온돌방 중 어디로 드릴까요?	온돌방으로 주세요
혹시 흡연 가능한가요?	내부에선 금연이고 따로 흡연실이 마련되어있습니다
여기 복층구조가 있는 것 같던데요?	복층 방 있어요
언제로 해드릴까요?	다음 주 금요일이요
오늘 밤 숙박할 방이 있나요?	방이 딱 하나 남아 있어요
카드로 결제해주세요	알겠습니다
요금은 각각 어떻게 되나요?	온돌 룸은 십이만 칠백원이고 트윈 객실은 이십팔만원이에요
그럼 대인 2명만 계산해 주세요	18000원입니다
수영장은 이용할 수 있나요?	수영장은 5월부터 이용 가능해요
공이 안 좋은데 다른 공으로 교체 가능할까요?	바꿔드리겠습니다
6살짜리 아이들 가려고 하는데 키즈시설 따로 있나요?	키즈시설은 따로 없어요
고기는 있어서 바비큐 할 때 숯만 피워주시면 되는데 얼마에요?	2만 원이에요
셔틀버스는 어디서 타면 되나요?	000역에 4시에 셔틀버스 탑승하시면 돼요
컬러 프린트도 할 수 있나요?	흑백 프린트만 가능합니다
대가족 총 여덟명이 묵으려고 하는데 큰 방이 있나요?	일랑일랑 방이라고 복층 방인데, 이층에는 침대가 두 개, 밑에는 거실처럼 자도 돼요
몇 분이신데요?	다섯 분 묵으실 방 있어요
여기 한 시간 이용료는 얼마인가요?	천 원입니다
화장실 어디에 있어요?	화장실은 저 끝으로 가시면 돼요
위치가 조용한가요?	저희 펜션 주위는 조용해요
포켓볼 한 팀이랑 사구 한 팀 자리 있나요?	사구는 지금 시작하고 포켓볼은 기다릴게요
예약자가 아직 안왔는데, 다른 방법으로예약 확인은 불가능할까요?	약자분께서 전화 주시면 확인 가능해요
콜라 두 잔이랑 커피 한 잔 주세요	준비해서 갖다 드릴게요
수영장은 몇 시까지 이용 가능한가요?	오전 10시부터 오후 10시까지 이용 가능해요
고기나 야채는 어디서 구입 가능한가요?	매점에서 구입하시면 돼요
제가 강습 받고 싶어하는 애를 데리고 한 번 나와봐야 되겠네요	그러세요. 데리고 나오세요
혹시 자리 예약 가능한가요?	자리 예약은 10분 안에 오셔야 가능하세요
두 명 숙박이요	1박에 6만 원이에요
트윈 룸 남는 방 있나요?	전망은 어떤가요?
총 가격이 그럼 얼마인가요?	5인용 방 8만 원에 바비큐 비용 만 원씩 더해서 13만 원 주시면 됩니다
포켓볼 자리도 있나요?	현재는 없습니다
체크인은 몇 시쯤 예상하시나요?	그럼 이번 주말 3시에 뵐게요
오늘 4명 예약하셨죠?	4명이에요
저희 예약해주시고 화장실이 어디죠?	밖에 나가셔서 우측으로 가시면 보이세요
숙박 시 바비큐 요금은 어떻게 되나요?	숙박 인원 2인 기준 4만 원이에요
배달음식 같은 거 시켜 먹을 수 있나요?	배달음식 시켜 드시면 돼요
4구 치려고요	저쪽으로 가세요
혹시 와이파이는 다 설치되어 있나요?	여기는 안되어있는 걸로 알고 있어요
아 5만 원짜리는 안 들어가는데요	카운터에 오시면 교환해드리겠습니다
시티 뷰로 예약했는데 혹시 오션뷰로 변경 가능할까요?	방은 701호로 바꿔드렸고, 키는 여기 있어요
하루 숙박 비용은 어떻게 되나요?	일반 룸은 1박에 50000원이에요
세면도구는 다 구비가 되어 있나요?	세면도구는 다 있어요
바비큐장은 이용하면 얼마에요?	1인에 2만 원씩 추가하시면 됩니다
여기 후불카드 사용 가능한가요?	후불은 안되고 회원가입해주셔야 합니다
방을 바꾸는 거 말고는 방법이 없어요?	불편을 드려 정말 죄송해요
지금 전화받는 곳은 어디인가요?	저희는 경주 프런트예요
바비큐장 이용하시겠습니까?	장작과 숯불은 제공해드릴게요
숙박 가격은 얼마인가요?	15만 원이에요
따로 결제가 필요한가요?	나가실 때 후불로 결제하시면 됩니다
수건이나 세면도구는 다 구비되어 있나요?	세면도구는 다 있어요
일반룸과 스위트룸의 차이가 무엇인가요?	스위트룸은 금박이 되어 있어요
네, 내일 토요일 오전 11시에 체크아웃이에요	알겠습니다
추가 인원에 대한 엑스트라 베드가 있나요?	엑스트라 베드가 있는 방으로 준비해드릴게요
장갑은 인원수만큼 해요?	준비해 드릴게요
음식 주문도 가능한가요?	피씨 화면상에서 주문하시면 가져다드립니다
매일 새벽 3시까지인가요?	주말에는 시간은 똑같은데 마치는 시간은 없어요
파티룸에 풍선장식을 하고 싶은데 가능한가요?	장식은 직접 하셔도 되고 비용을 추가하시면 저희가 해 드리기도 해요
와이파이는 되나요?	와이파이가 되는데 조금 약할 수는 있어요
몇 시간 동안 머무르시나요?	3시간에 4만 원이에요
방이 몇 층인가요?	2층 안쪽 방이고, 거실이랑 방 두 개 있어요
남자 3명이서 잘 건데 디럭스룸에 침대 3개 있나요?	침대는 1개인데 2인용이고 엑스트라 베드 넣으셔야 돼요
여기 삼성페이로 결제 할 수 있어요?	삼성페이 결제 가능합니다
저희 바비큐 하려고 하는데 숯이랑 석쇠 어떻게 해야 하나요?	저희가 저녁시간쯤 준비해 드릴게요
몇 분이신가요?	어른 둘 아이 둘이요
오늘 투숙하실 건가요?	주말에 빈 방이 있는지 확인해 볼게요
비상약은 준비되어 있나요?	필요한 약 있으면 말씀해 주세요
어떻게 가입해요?	오른쪽에 버튼 있어요
예약하신 분 성함 좀 알려주실래요?	김지영입니다
배달 메뉴판을 주시겠습니까?	중국집과 치킨집 메뉴판만 있습니다
이 PC방은 후불 사용이 안 되는가 봐요?	선불만 됩니다
디럭스 트윈으로 두 개 하면 가격은 얼마인가요?	디럭스 트윈은 삼십오만원이라서 두 개 하시면 총 칠십만원이에요
포켓 다이 있나요?	있어요
총 몇 분이 서 숙박하실 건가요?	총 3명입니다
네, 영수증 필요하시나요?	필요해요
숙박은 언제부터 하시겠습니까?	모레부터 하겠습니다
신라면이랑 진라면 있는데 어떤 걸로 드릴까요?	진라면으로 주세요
그럼 일단 일반석 앉을 테니 말씀해 주세요	빨리 자리가 생겼으면 좋겠네요
잠시만요, 몇 명이세요?	저희가 가족이 7명이라서 방이 좀 커야 할 거 같아요
말씀해주신 큰 방도 뷰가 좀 괜찮나요,  바다가 보이나요?	전 객실 오션 뷰라서 전망은 좋아요
체크인 하려면 언제쯤 오면 될까요?	오후 1시쯤이면 준비가 끝날 것 같아요
바비큐 이용하는 건 무료인가요?	중자 2만원인데, 4분 이용하시니까 바비큐는 하나 서비스로 해 드릴게요
카드 가능한가요?	카드 돼요
혹시 주차할 데 여기 어디 있나요?	이 건물 지하주차장에 주차 하시면 됩니다
할리우드 방, 이용 가격은 얼마인가요?	할리우드 방은 십구만 팔천 원이에요
당구장 영업시간이 몇 시부터 몇 시까지 인가요?	10시에서 10시 반 사이에 문 열어가지고 새벽 4시까지 해요
결제는 현금으로 할 테니까 현금영수증 부탁드려요	알겠습니다
결제는 상품권으로 가능한가요?	신세계 상품권 가능해요
디럭스 더블룸 금액은 어떻게 되나요?	디럭스 더블룸 평일 가격은 십만 원이에요. 조식은 별도로 만 원씩 추가되는데, 세미 뷔페식으로 한식, 양식이 나와요
일단 자리에서 회원가입을 해주세요	아이디는 만들었어요
5분 기다렸다 3명 앉을게요	금액권은 앞에 기계에서 끊으시면 됩니다
모텔 이름을 정확히 말씀해 주실래요?	편한 모텔이라고 해요
지금 가면 바로 게임할 수 있어요?	가능합니다
한 명 추가할 수 있나요?	추가하실 수 있어요
얼마에요?	5만 원이에요
컵라면 같은 거 파나요?	준비되면 알려드릴게요
한번 물어보고 시간을 어떻게 조율하든지 하고 새로 전화드릴게요	전화 주세요
1시간 추가 비용은 얼마죠	시간당 천 원입니다
체크인 시간은 몇 시인가요?	체크인은 오후 세 시부터 가능하세요
프런트에 있는 식빵은 뭔가요?	아침에 커피와 드시도록 무료로 제공되는 서비스에요
거기 당구장인가요?	맞습니다
요금은 한 시간에 얼마 정도 하나요?	요금은 한 시간에 1000원입니다
짐 맡길 수 있나요?	총 세 개 맡기셨고 나중에 찾으실 때에 이 영수증 보여주시면 돼요
몇 시까지 퇴실해야 하나요?	오전 11시가 퇴실 시간이에요
2인실 3명으로 해서 예약 잡아주세요	예약해드렸어요
대실 하시나요?	지금 청소 중이라서 조금 기다리셔야 해요
문은 안 잠겨있나요	사용 바로 하실 수 있습니다
여기서 프린트 가능한가요?	그런데 인쇄요금과 별도로 이용요금은 1시간으로 내셔야 합니다
하룻밤만 묵으시는 건가요?	키 드릴게요
그럼 일단 일반석 앉을 테니 말씀해 주세요	오래 걸리지 않을 거예요
이번 주말에 숙박할 수 있는 방이 있나요?	있어요
배그 할 건데 컴퓨터 사양이 어떻게 돼요?	배그는 렉 전혀 없이 돌아갑니다
오션뷰와 시티뷰 중 어느 걸로 하시겠습니까?	오션뷰요
후불결제도 가능한가요?	후불결제도 물론 가능합니다
혹시 흡연실은 있나요?	화장실 옆쪽으로 가시면 있어요
몇 시부터 체크인 가능하죠?	체크인은 오후 3시부터 가능해요
내일 몇 시까지 체크아웃해야 하나요?	11시까지 정리 후 연락 주시면 돼요
현금으로 되지요?	현금 결제 돼요
29일 2인 숙박 예약 가능할까요?	가능해요
그걸로 예약 가능할까요?	이 방으로 예약 잡아드릴게요
한 시간에 얼마나 하나요?	1000원입니다
아까 그 방으로 주시겠어요?	바로 안내해드릴게요
결제할 때 카드도 가능한가요?	2000원 이상만 카드 결제 가능하세요
금연석으로 주세요	10번 11번 자리를 이용하시면 됩니다
화장실 어디 있어요?	화장실은 나가셔서 오른쪽 보시면 있습니다
1박에 얼마죠?	부가세 포함 20만 원이에요
바비큐를 할 수 있는 도구와 음식이 준비되어 있나요?	사용료를 지불하시고 대여하시면 돼요
흡연실은 어디있어요?	흡연실은 화장실 옆에 있습니다
주위에 볼만한 경치나 관광지가 있나요?	여기가 보문관광단지라서 식물원이 좋아요
체크아웃 시간은 언제인가요?	체크아웃 시간은 오전 11시에요
바비큐 이용시 따로 추가 요금은 없나요?	기본 숯은 제공되고 추가 숯은 만 원에 구입하실 수 있어요
선불인가요?	여기서 결제하시면 카드를 드리는데 그 카드에 적힌 번호 자리로 가시면 됩니다
호텔 안에 편의시설은 어떤 게 있나요?	지하 일 층에는 노래방과 편의점, 헬스장, 사우나가 있고 이층에는 다양한 바가 있어요
네 이거 카드 가져가서 접속하면 되죠?	아무 카드나 가져가셔서 하면 되세요
몇 명이 이용할 실 건가요?	20000원이에요
친구 식구가 간다면 인원이 더 추가되는 것도 가능하죠?	여섯 분이시면 조금 더 넓은 민들레 방이라고 있는데 그 방 하셔야 해요
피트니스센터는 몇 층에 있나요?	7층에 수영장과 함께 위치하고 있어요
내일 숙박 예약 가능한가요?	일반실과 특실 둘 다 가능해요
삼성페이나 카카오페이도 혹시 가능한가요?	삼성페이나 카카오페이 가능합니다
네 몇 명이세요?	3개 주세요
혹시 커플석이라든지 이런 건 있나요?	커플석은 없습니다
여기 배그 잘 돌아가요?	배그는 충분히 돌아갑니다
가족 8명이 이용하려고 하려는데, 큰 방 있나요?	큰 방은 1박 2일로 35만3천원 되세요
어른들은 안 되나요?	어른들은 안돼요
음식 주문은 어떻게 하면 되나요?	자리 가셔서 컴퓨터로 주문하세요
수영장이나 이런 편의시설을 이용할 수는 있나요?	수영장은 투숙객분들은 무료로 이용이 가능하신데, 외부 수영장밖에 없어요. 겨울에는 수영복보다는 래시 가드라든지 겉옷 챙겨오셔야 할 거예요
일행이 많은데 할증은 몇 명부터 붙어요?	5인 이상이면 50퍼센트 할증 적용됩니다
인원 추가 시 발생되는 비용이 있나요?	인당 1만 원 추가돼요
아침도 포함이 되나요?	저희는 조식 없어요
네 몇 분이 치실 거예요?	3명이요
바비큐 그릴 대여 비용은 얼마죠?	독채로 예약을 하시면 1인당 발생하는 바비큐 비용이 무료 포함되세요
어플 쿠폰 할인 적용해주세요?	죄송하지만 성수기 주말에는 쿠폰할인이 적용되지 않아요
배그 깔려있나요?	배그랑 오버워치 롤 등 거의 다 깔려있어요
세면도구는 다 있나요?	세면도구는 다 구비되어 있어요
카드 결제되나요?	카드 결제는 어려워요
다음 주 토요일 가족 단위로 갈 건데요?	다음 주 토요일 가능하세요
추가로는 어떻게 계산되나요?	한 시간 이후부터 삼십분당 500원으로 계산됩니다
몇 분이 서 주무실 건가요?	2명이요
회원가입하실 건가요?	방법 좀 알려주세요
일주일 전에 전화를 드려야겠네요?	일주일 전에 전화 주세요
저희 포켓볼 치려고요	그럼 저기 제일 끝에 있는 곳으로 가주세요
다시 한번 전화드릴게요	전화 주세요
여기 3구요	창가 옆 테이블로 가시면 됩니다
여기서 얼마나 걸리나요?	도보로 한 5분 정도 걸려요
체크아웃 시간은요?	체크아웃은 다음 날 11시요
이불은 넉넉하게 있나요?	이불은 걱정 안 하셔도 돼요
음식 주문이라든지 이런 거도 가능한가요?	음식 주문 가능합니다
객실이 몇 평, 몇 평 있나요?	오인실용으로 서른한평형, 스물여덟평형이 있는데, 둘 다 방 두 개 거실 하나예요
바비큐 구워 먹을 수 있는 장비가 준비되어있나요?	바비큐 장비는 모두 지원해드려요
만삼천원, 일 인당이죠?	일 인당 헬스장과 온천 사우나 가격이에요
당구 몇 치시나요	알고 있습니다
이불은 넉넉히 있나요?	이불이 모자라면 말씀해 주세요
침대방 가격은 얼마인가요?	일반실 토요일 가격이 전면 쪽은 십사만원, 후면 쪽은 십삼만원이에요
픽업은 해주시나요?	픽업은 되지 않아요
네, 고객님 혹시 봐두신 객실이 따로 있으신가요?	해당 날짜에 디럭스 룸이 2개가 비어 있는 데 옵션이 자쿠지와 시어터가 있어요
혹시 피시방 영업시간이 어떻게 돼요?	영업시간은 24시간입니다
단체 예약도 되나요?	단체 예약받아요
네, 얼마나 묵으실 예정이신가요?	한 달 정도 있을 예정입니다
카드 결제 가능하죠?	카드 주시면 결제할게요
결제 해주시고 현금영수증 발행해주세요	현금영수증 발행 번호 입력해주세요
이제 되는 건가요?	즐거운 게임 하세요
저희가 그릴이랑 숯은 대여해드리는데 필요하세요?	주세요
오늘 날짜로 예약했는데, 확인 되나요?	여기 603호 키 있고, 오른쪽으로 돌아가면 엘리베이터가 있어요
일회용품 필요하세요?	총 26000원 계산해드릴게요
몇 분이 이용하시나요?	총 2명입니다
여기 시간당 얼마인가요?	오픈 이벤트로 1시간당 6천 원이에요
근처에 아침 식사 가능한 곳은 있어요?	저희가 일곱 시 반에서 아홉 시 반 사이에 조식이 나와요
6명 모임으로 갈 예정인데 다음다음주 토요일쯤 얼마쯤 하나요?	저희가 토요일은 주말 가격이 적용돼요
오월 오일에 가족 네 명이 묵으려고 하면 가격이 얼마나 돼요?	일반실 바다 뷰 기준으로 연휴 기간 한 객실당 요금은 사십이만 삼천오백 원이에요
디럭스 룸에는 담배 냄새 안 나는 방이 있을까요?	디럭스 룸에는 담배 냄새 안 나는 방이 있어요
귀중품은 카운터에서 보관해주시나요?	저희 프런트 금고에서 보관을 해드려요
몇 학년이죠?	이학년이요
펜션 근처에 관광지라든지 있나요?	불국사는 오 분 정도 거리고 경주 보문단지가 한 십 분 정도 거리에요
평일에는 4명, 7만원이에요?	평일에는 4명, 이용요금 7만원인데, 6만5천원까지 해드릴게요
라면이나 햄버거 콜라도 파나요?	저쪽에 있습니다
혹시 흡연 가능한가요?	죄송하지만, 금연이에요
주변에 무슨 시설이 또 있나요?	주변에 안압지, 첨성대, 보문은 차 타고 십 분 거리에 다 있어요
방 하나를 예약하려고 하는데요?	기준 인원이 4명이라서 한 명은 추가 비용을 내셔야 합니다
짐을 맡겨두고 나갔다 와도 될까요?	다녀오세요
예약자분 성함이 어떻게 되세요?	홍길동입니다
네, 몇 분이 서 묶으시나요?	성인 5명에 어린이 5명인데요
몇 시간인가요?	대실 사용시간은 3시간이에요
죄송하지만, 조식 뷔페는 확인이 되지 않는데, 예약 하셨나요?	확실히 패키지로 같이 결제했어요
당구 좀 배워보려고하는데, 대회에 갈 수 있게끔 가르치고 싶은데요?	아, 그러면 선수 반 육성으로 들어가셔야해요
일회용품 필요하신가요?	1천 원씩 추가요금이 붙어요
숯이랑 고기 포함된 가격인가요?	포함이고 1인분 추가 시 5000원씩이에요
비밀번호 좀 찾아주실래요?	아이디는 본인 성함이시고 비밀번호는 본인 성함하고 44 이시네요
계산은 선불로 하시겠습니까	게임 끝나고 한 번에 할게요
컴퓨터 사양은 혹시 어느 정도에요?	그래픽카드 gtx1080입니다
정우성 씨 이름으로 독채 1박 예약하신 거 맞죠?	맞아요
커플 PC로 예약하신 것 맞으신가요?	커플 PC로 예약했습니다
오늘 5명 묵으려고 하는데 방 있을까요?	방 있어요
어른이 총 4분이세요?	어른이 4명이에요
몇 인실 원하시나요?	4인실이 필요해요
체크인 시간이 몇 시부터인가요?	체크인은 오후 두 시부터이고, 체크아웃은 열두 시 전까지 해주시면 돼요
세면도구나 이런 건 다 구비되어있나요?	칫솔이랑 면도기나 화장품만 없어요
저희 전산상으로 확인이 되지 않는데, 문자 보여주시겠어요?	여기 문자로는 조식 뷔페 포함으로 나옵니다
자리로 김밥이랑 라면 준비해주세요	준비해 드리겠습니다
조금만 생각해보고 전화드리겠습니다	전화 주세요
한 시간에 얼마에요?	7000원입니다
요금은 10분에 얼마에요?	10분에 중대는 1500원 받아요
이번 주말에 빈 방 있나요?	이번 주말에 빈 방 있어요
배달음식을 시켜 먹어도 되나요?	여기 있는 전단지에서만 시키실 수 있으세요
1박 하실 건가요?	1박입니다
그럼 4구 치다가 자리 나면 옮겨 줄 수 있나요?	그렇게 해드릴게요
돈가스 2인분만 주세요	조금만 기다려주세요
칼라로 인쇄하고 싶은데 도와주세요	잠시만 기다려주세요
몇 시부터 체크인이 가능한가요?	3시부터 가능해요
예약 취소할 수 있나요?	약 취소는 불가능해요
한 시간에 얼마예요?	10분에 1300원이고 한 시간은 7800원입니다
어떤 스타일의 방으로 드릴까요?	모던 룸은 1박에 2만5천 원이에요
음료는 어떤 거 가져다드릴까요?	저기 13번 자리 쓰시면 됩니다 음료 갖다 드릴게요
당구장 자리 있나요?	딱 한 테이블 남았어요
엑스트라 베드는 안 되나요?	엑스트라 베드는 트윈 객실만 가능하세요
카라반 4인 가족 예약 가능한가요?	4인실은 꽉 찼고 6인실 남았습니다
혹시 오버 위치도 깔려있나요?	물론이죠
객실 전망은 바다가 보이는 곳으로 되나요?	바다전망은 가격이 조금 더 비싸요
침대방인가요?	온돌방이에요
저 1시간이요	10번 자리 이용하시면 됩니다
가격이 올라서 얼마나 해요?	오른 가격으로 10만 원이에요
회원가입은 자리에서 하면 되죠?	로그인 화면에서 하시면 됩니다
뷰가 좋은 방은 따로 있나요?	저희 펜션은 오션뷰라서 바다는 다 보이고, 오동도와 마주 보고 있어요
엑셀로 자료를 좀 뽑으려면 한 장당 얼마나 하나요?	저희가 지금 프린트가 고장나서 출력이 안돼요
여기 처음 오는데 어떻게 이용하면 되나요?	1박에 3만 원이고 자리는 아무 데나 잡으시면 돼요
공휴일에도 다 영업하시는 건가요?	다른 가게는 모르겠지만 공휴일에도 영업하고 있어요
네, 내일 토요일 오전 11시에 체크아웃이에요	여기 키 받으시고 509호로 가시면 돼요
일반실과 특실 가격 차이는요?	특실이 1박당 5만 원 더 비쌉니다
흡연실은 따로 마련되어 있나요?	다른 구역은 금연이라 흡연실에서만 흡연 부탁합니다
와이파이는 다 설치되어 있나요?	와이파이 다 설치되어 있어요
4구 자리 주세요	만석이라 20분 정도 기다리셔야 해요
예, 며칠 토요일이에요?	사월 육 일 일박 이일 이용하려고 하거든요
대실 하려고 하는데 방 있나요?	방 하나 남아 있어요
회원 등록은 어디서 할 수 있나요?	저희 매장 방문하셔서 가입 가능합니다
빈방 2개 있을까요?	지금 빈 방은 하나 밖에 안 남아 있네요
피시방 1시간 이용에 얼마인가요?	회원은 1시간에 천 원이고 비회원은 1시간에 천이백 원입니다
여기 시간당 얼마예요?	1시간에 10000원입니다
경주에요?	경주에요
사월 이십칠일에 가려고 하거든요?	사월 토요일은 회원분들 예약 기간이라 일반분들 예약을 안 받고 있어요. 원하시는 날짜 일주일 전에 회원분들 예약 끝나고 남은 객실이 있으면 저희가 예약을 해드릴 수 있어요
어느 자리로 가서 하면 되나요?	모든 자리에서 출력 가능합니다
자리가 있나요?	있습니다
네, 예약하셨어요?	12시 입실인데 일찍 왔어요
한 시간에 얼마인가요?	오천 원입니다
상의해보고 전화를 다시 드릴게요, 근데 생각보다 비싸긴 하네요	주말이라서 가격이 높아요
회원가입을 해야지만 이용을 할 수 있나요?	비회원도 이용 가능합니다
한 열두 시 정도에 입실하려면 미리 전화를 드려야 되는 거예요?	전날에 손님이 안 묵으시는 방이면 더 일찍 오셔도 상관은 없는데 일단 전화를 주세요
아침은 주나요?	저희는 조식이 없어요
몇 시에 나가야 되나요?	밤 12시 전에 나가셔야 해요
흡연실 있나요?	저쪽 코너에 오른쪽으로 보시면 흡연실 있습니다
음료수 좀 주세요	서비스 음료 가져 다 드리겠습니다
일반 방이랑은 가격 차이가 얼마나 나요?	일반 방이랑은 삼만원 차이 나는데 일반 방은 욕조에 공기 방울 나오게 해서 버블스파가 돼요
라면 주문 가능한가요?	컴퓨터에서 주문장 이용해주시면 됩니다
영업시간 알 수 있을까요?	24시간 연중무휴 입니다
처음 왔는데요	선불 금액 등록해서 편하게 결제하실 수 있고 포인트도 적립해드려요
2명 자리 있어요?	저쪽으로 안내해 드릴게요
바비큐 하려고 하는데 가격이 어떻게 될까요?	20000원 내시면 다 해드려요
한 시간에 얼마에요?	9000원입니다
당구장 지금 영업하죠?	새벽 6시까지 합니다
시간당 얼마인가요?	1000원입니다
이번 주 토요일에 숙박이 가능한가요?	이인실에 네 명 주무실 수 있어요
음식 주문은 어디에서 하나요?	자리에서 음식 주문 가능합니다
바비큐 파티에 아이와 함께 가도 되죠?	보호자만 있으시다면 가능해요
포켓볼 칠게요	포켓볼은 저쪽 당구대 이용하시면 됩니다
얼음 넣어 드릴까요	하나는 얼음 빼주세요
컴퓨터는 아무거나 사용해도 되나요?	편하신 자리를 사용하세요 여기 비회원 카드입니다
그럼 언제쯤 되나요?	수리하는데 조금 걸려요
회원가입을 해야지만 이용이 가능한가요?	비회원도 이용 가능하세요
출력 버튼 눌렀는데 흑백 5장 확인 부탁드립니다	흑백 5장 맞네요
오월 초에 일박 정도 사용하고 싶어서요?	오월 사일이 토요일이라서 일반실 침대방이 아침 식사 뷔페 두 명, 일박에 부가세 포함하면 십오만 원이에요
혹시 비상구는 어느 쪽에 있어요?	비상구는 저 쪽에 있습니다
10분 정도 기다려 주실 수 있으세요?	지금 급하게 인쇄해야 합니다
어플 할인받으려면 어떻게 해야 되나요?	저희는 어플 할인이 안돼요
오늘 김희선 이름으로 방 두 개 예약했는데 확인해 부탁드려도 될까요?	오늘 김희선 이름으로 파티룸 2박 예약되어 있어요
펜션 근처에 관광지나 볼거리 있나요?	펜션이 보문관광단지랑 불국사도 가깝고 서로는 반대편에 있어요
주차장도 있나요?	건물 타워주차장이 있어요
주차권 끊어주실 수 있나요	저희 pc방 이용하시면 끊어드릴 수 있습니다
하루에 얼마예요?	1박에 5만원이에요
체크인 시간은 몇 시에요?	체크인은 3시부터이고 체크아웃은 11시에요
체크아웃 시간은 몇 시죠?	12시예요
네, 제휴 카드 있으신가요?	신한카드로 결제 할게요
인터넷으로 예약했는데요?	아늑이 방으로 가시면 돼요
요금은 카드로도 계산이 가능한가요?	카드로 계산 가능합니다
금액은 어떻게 되나요?	1박에 14만 원이에요
펜션 예약하려는데 1박에 얼마 인가요?	기본 하루 8만 원이에요
샤워장이 따로 있습니까?	샤워장은 주차장 왼편에 마련되어 있어요
조식 이용 시간은 몇 시부터 이용이 가능한가요?	조식은 일곱시 반부터 제공돼요
청소년들은 몇시까지 이용이 가능한가요?	청소년들은 부모님 동반하면 늦게까지 가능하세요
야놀자'에 들어가서 봤는데 거기 산호 룸은 몇 명 정도 묵을 수 있나요?	산호 룸은 한 여섯 명 정도 잘 수 있어요
골프장을 이용하려면 몇 시까지 가야 하나요?	파크골프장이라 해가 떠 있는 시간에만 이용이 가능하세요
한 시간에 얼마인가요?	한 시간에 1500원입니다
체크인하는 시간하고 체크아웃하는 시간은 어떻게 되나요?	체크인은 오후 세 시고, 체크아웃은 다음날 열두 시까지예요
음료 결제는 어떻게 하나요?	회원가입하시고 카드 등록 후 결제하시거나 나가실 때 결제하시면 됩니다
바비큐 이용 가격은 얼마인가요?	2시간에 2만 원이에요
예약하고 오신 건가요?	약 안 했어요
언제까지 소리 없이 게임해야 해요?	잠시만요 사장님 불러올게요
네, 얼마인가요?	1박에 5만 원이에요
사구는 얼마나 기다려야 하나요?	상이 어렵네요
라면 하나 주문할게요	주문 버튼 눌러주세요
배달 음식은 알아서 시켜 먹음 되죠?	원하시는 거 여기 주소로 시키셔요
계산서에 세금과 서비스료를 포함한 것인가요?	세금 포함 된 가격이에요
몇 시간 이용 가능한가요?	3시간 이용 가능하세요
카드로 결제가 가능한가요?	카드로 하실 때는 선불 기계에서 해주시면 됩니다
부대시설에 스파도 있나요?	저희가 스파 시설은 따로 없어요. 수영장이랑 헬스장이 성인은 세 시간까지 무료로 이용이 가능하세요. 사우나는 오십 프로 할인받으셔서 한 분에 이만 이천 원으로 이용이 가능하세요
샴푸나 린스 그런 거 다 구비되어 있나요?	샴푸, 린스, 치약, 그 정도는 구비되어 있어요
아이들이랑 바비큐 해먹을 수 있는 장소가 있어요?	바닷가에 바비큐장이 따로 있어요
수영장, 탁구대는 이용요금 따로 지불해야 하나요?	수영장, 탁구대 이용료는 따로 없어요
라면 두 개도 끓여주세요	이 중에서 라면 골라주세요
룸은 몇 개를 예약해야 하나요?	방 같은 경우에는 디럭스 트윈 두 개 하시든지 스탠다드 더블 하나에 스위트룸 하나 하시는 경우도 있어요. 제 생각에는 디럭스 트윈으로 두 개 하시는 게 나을 것 같네요
혹시 와이파이는 설치되어 있나요?	IPTIME이라고 와이파이 설치 되어 있어요
예약자 성함이 어떻게 되세요?	김기동입니다
바비큐도 추가로 신청 할 수 있나요?	죄송하지만, 바비큐는 사전에 예약해주셔야해요
어느 자리에 앉으면 되나요?	인쇄하실 거면 1번 자리에서 하시면 됩니다
일반 뷰 바다 뷰 두 가지인데 어느 방을 원하세요?	바다 뷰로 해주세요
하루 숙박에 비용은 얼만가요?	12만 원이에요
3박 묵으려고 하는데 얼마죠?	9만원이고, 선불이에요
이거 무인발권기가 지금 안되네요	고객님 지금 현재 고장이라 카운터에 직접 말씀해주셔야 합니다
스위트룸 객실료는 얼마에요?	스위트룸 평일은 십만 원을 받고 있어요
혹시 여기 와이파이는 다 있나요?	와이파이 사용 가능합니다
카카오페이나 삼성페이도 가능한가요?	카카오페이랑 삼성페이 결제 가능하세요
흡연실은 어디죠?	화장실 앞쪽에 있습니다
제휴사 할인 혜택 있나요?	제휴사 할인은 따로 없어요
호텔 측에서 주시는 무료 제공되는 음료가 있나요?	기본적으로 생수 일인 한 병 나가요
더블룸도 조식 비용을 포함해서 말씀해주시는 거죠?	더블룸도 조식을 포함한 요금이에요
지금 1인 객실 있나요?	아뇨, 1시간 정도 후에 이용할 거예요
혹시 바비큐 파티도 가능한가요?	추가로 인당 만 원만 내시면 돼요
헤드폰에 소리가 나지 않습니다	새 걸로 교체해드리겠습니다
성함이 어떻게 되시나요?	한진욱이요
하다가 연장하고 싶으면 어떻게 해요?	저 앞에 보이는 카드 충전기에서 돈 넣고 충전하시면 돼요
10층으로 예약 부탁드려도 되나요?	예약해드릴게요
가입하면 당구 채 등을 맡겨놓을 수 있을까요	물론입니다
몇 시에 체크아웃 하면 되나요?	낮 12시까지는 체크아웃하셔야 해요
3구 하나 주세요	저쪽 안쪽 다이 이용하시면 돼요
보통 이삼주 전에는 예약을 해야 하는 거죠?	다른 날짜는 괜찮은데, 고객님이 말씀하신 날짜는 단체 예약이 있어서 예약이 좀 어려워요
4구 테이블 하나 주세요	그러면 카운터 옆에 있는 테이블 쓰시면 됩니다
네, 인원이 몇 명인가요?	어른 둘 아이 한 명이요
성인이 몇 분이세요?	성인이 6명이고 아이가 2명이고요
현금이 없어서 그런데 카드로 결제도 되나요?	죄송하지만 카드는 안됩니다
요즘은 컴퓨터로 주문하는데 자리에 앉으셔서 한번 보시고 주문해주세요	자주 와야겠어요
평일 할인되는 가격으로 묵을 수는 없나요?	평일이라 이미 할인해 놓은 거예요
네분께서 같은 객실을 이용하시는 거예요?	객실 하나면 돼요
바비큐장도 되어 있는데 가능한가요?	드시는 거는 챙겨오셔도 되지만 숯불 비가 2만원이고 저희 세트 바비큐가 있는데 두 분에 5만원이에요
이벤트가 있다고 들었는데 맞나요?	현재 원 플러스 원 이벤트 진행 중입니다
자리 하나 주세요	이쪽으로 오세요
이번 주말에 2인 2박 예약하고 싶은데 혹시 가능한가요?	예약 가능해요
페이스북 이벤트 보고 왔는데요	이벤트 숙박은 20프로 할인해서 4만 8천 원이에요
서비스인가요, 아님 돈 내야 하나요?	서비스입니다 손님
이 당구장에서는 되는 게 뭔가요?	4구와 3구가 가능합니다
예약 좀 부탁드려도 될까요?	언제든 예약은 가능하세요
거기 1시간 이용 요금이 얼마인가요?	천 원입니다
경주에요?	경주는 유적지도 많고 볼 게 많아요
1000원도 카드로 결제해도 되나요?	1000원도 카드 결제 가능합니다
방은 따뜻한가요?	방은 개별 보일러 조절하시면 돼요. 한 겨울에도 두꺼운 이불이 필요하지 않아요
바탕화면에서 헤드셋 버튼 눌러보셨어요?	근데 아무런 변화 없고 여전히 안 들려요
1시간에 얼마에요?	6000원입니다
여기 건물에 주차할 수 있는 곳은 있어요?	주차타워가 있습니다
비흡연석은 어느 쪽인가요?	오른쪽입니다
조금 고민해보고 전화드리도록 하겠습니다	제가 URL 하나 보내 드릴 테니 네이버로 쉽게 예약할 수 있을 거예요
혹시 여기 피시방 영업시간은 어떻게 되세요?	영업시간은 24시간입니다
5시간 결제하면 할인되나요?	할인됩니다
계산은 카드로도 혹시 가능한가요?	카드는 3000원 이상 가능합니다
비흡연석은 어디인가요?	오른쪽 칸막이가 있는 부분을 빼고는 전부 비흡연석입니다
짜장면 배달해도 되나요?	됩니다
자리에서 흡연 가능한가요?	흡연은 불가합니다
그럼 음료수 하나랑 2시간 미리 결제해주세요	자리로 가져다드리겠습니다
주차는 한 대만 가능한가요?	두 대까지 주차권 드려요
침구류 추가 가능한가요?	최대 두 분까지 추가 가능해요
조식비가 포함된 가격이에요?	아니요, 조식비는 별도에요
혹시 짜장면 시켜 먹어도 되나요	외부 음식은 반입금지입니다
계산 좀 해주실래요	900원 결제 도와드릴게요
2일 예약하신 거 맞으시죠?	방으로 안내해 드릴게요
그나저나 여기 화장실이 어디였죠?	나가서 오른쪽에 바로 있습니다
저희 왔는데요	이쪽으로 안내해 드릴게요
체크인 시간은 언제인가요?	3시가 체크인 시간이고 일찍 오시면 전화 주세요
조식은 다 제공되고 있고요?	조식은 불포함이에요
추가는 어떻게 되죠?	1시간에 만 원이에요
근처에 마트 있나요?	1km 이내에 편의점이랑 마트가 있어요
조식 뷔페은 몇 시부터 이용이 가능한가요?	조식 뷔페 시간은 일곱 시부터 열 시까지 이용이 가능하세요
네, 언제로 예약하시게요?	금요일 7시 반이요
네, 음료수는 뭘로 드릴까요	자리로 가져다드리겠습니다
크리스마스에 예약하려고 하는데 자리 있나요?	남는 방 있어요
정액제로 끊으면 할인되나요?	10일 끊으시면 1일은 무료로 사용하실 수 있습니다
체크인 되나요?	체크인 되었어요
조식은 나오나요?	저희 조식은 따로 없어요
12시간 사용하면 얼마인가요?	10000원입니다
와이파이는 다 설치되어있나요?	와이파이가 설치되어 있습니다
어디에서 예약하면 될까요?	공식 홈페이지에서 예약하시면 돼요
예약번호가 뭔가요?	7777입니다
보일러가 고장나서 며칠 잠깐 쉴라 했는데, 방 두개 하고 그러면 할인은 안되나요?	저희 사장님한테 여쭤봐야 해요
1박에 얼마죠?	1박에 5만원이에요
예약 된 방은 어디인가요?	왼쪽 엘리베이터 타시고 5층에서 내리시면 오른쪽에 있는 503호에요
초크는 어디에 있죠?	초크는 점수판 아래에 서랍에 있습니다
야외 캠핑장 이용하려고 하는데 텐트를 가지고 가야 되나요?	캠프장에 카바나가 설치되어 있어서 텐트는 가지고 오지 않으셔도 돼요
그리고 만두 추가해주세요	12번 자리로 가져다드릴게요
어디에 앉으면 되나요?	오른쪽 맨 끝에 앉으세요
여기 혹시 비상구는 어느 쪽에 있을까요?	비상구는 이쪽이랑 저쪽 흡연실 쪽에 있습니다
내일 몇 시에 퇴실인가요?	11시 퇴실이에요
몇 명이죠?	7명이요
흡연실은 따로 있는 있나요?	흡연실은 따로 있습니다
4인 가족 방은 1박당 얼마인가요?	4인실은 13만 원이에요
회원가입을 해야만 이용이 가능한가요?	비회원으로 이용 가능하세요
삼월 이십구일, 금요일이죠?	삼월 이십구일 금요일 맞아요
화장실은 어느 쪽인가요?	여성전용 당구대 뒤쪽으로 있습니다
이번 주 주말에요?	이십삼일 이십사일 일박 이일로요
체크인 시간은 몇 시에요?	세시 이후에는 체크인 가능하세요
디럭스룸 조식 포함 방으로 주실래요?	약 완료했습니다
발레파킹은 지원이 가능한가요?	프런트에 문의하세요
대실 하시나요?	숙박합니다
혹시 지금 4자리 있어요?	3자리는 있는데 4자리는 붙어있는 자리가 없네요
라면 하나 삼각김밥도 주문해도 될까요?	필요하신 거 있으면 PC에서 주문해주세요
빈 방이 있나요?	빈 방은 2개가 남았어요
몇 살부터 추가 요금 있나요?	만 3세부터요
10분당 얼마인가요?	1300원입니다
비상구는 어느 쪽에 있나요?	비상구가 없어요
저희 라면 주문할게요	이 중에서 골라주세요
네 혹시 음식 주문은 어디에서 해요?	자리에 가서 정보 입력하면 음식 주문할 수 있는 칸이 뜹니다
카드로 계산 가능한가요?	카드로 계산 가능하세요
네, 몇 분이 서 숙박하실 건가요?	어른 2명 아이 2명이요
음식 주문은 선불인가요?	후불입니다
고기는 저희가 구비를 해서 가야 하나요?	고기는 별도로 준비하셔야 해요
네, 혹시 2시에 오신다던 김철수 씨인가요?	제가 김철수입니다
애들이랑 같이 바비큐를 해먹을 수 있는 장소는 있어요?	바닷가에 그릴 장이 별도로 있습니다
짜장면 계산은 어떻게 하나요?	게임비에 추가됩니다
포켓볼 다이도 있나요?	두 테이블 있습니다
pc방에 처음 왔는데 어떻게 하면 되나요?	일단 자리를 잡고 정보를 입력하시면 돼요
28일에 숙박 예약하려 하는데 가능한가요?	예약 가능하세요
다음 주말은 예약 가능할까요?	다음 주말은 토요일 일요일 가능해요
몇 분이신데요?	5명이요
조식 말고 다른 편의시설 이용할 수 있는 건 없나요?	지금 다른 준비된 시설은 없어요
얼마인가요?	10분당 1200원입니다
온천 랜드는 돈을 지불하고 가야 하는 거죠?	온천 랜드는 요금을 내셔야 해요
여기 건물에 주차할 곳은 있어요?	주차할 곳은 없습니다
커플석 있나요?	있습니다
세면도구 세트도 비치되어 있나요?	세면도구 세트는 일회용으로 비치되어 있어요
지금 자리 있나요?	잠시 기다리셔야 합니다
흡연실은 따로 있나요?	그래서 다른 장소는 금연구역입니다
방음 같은 건 잘 되어있어요?	조금씩 소리가 들리기는 해요
캠핑장 전기 공급도 가능한가요?	24시간 가능해요
세면도구는 구비되어 있죠?	칫솔은 매점에서 구매가 가능하고, 나머지는 구비가 다 되어 있어요
이번 주 일요일에 숙박 가능한가요?	4인실 시티뷰와 오션뷰가 있어요
사이트에서도 예약을 진행할 수 있나요?	온라인으로도 예약하실 수 있어요
와이파이는 다 설치되어 있나요?	와이파이는 공용 와이파이 연결하시면 됩니다
현금영수증 하시겠어요?	잠시만 기다리세요. 키 드릴게요
라운지도 이용하고 싶은데 포인트로 가능할까요?	3000포인트 차감 후 이용 가능해요
시티뷰로 예약 해주실래요?	15만 3천 원이에요
아 참 그냥 자리 바꿔도 되죠?	그렇게 하세요
근처에  편의점이 있나요?	있어요
바비큐장도 있나요?	바비큐장 이용하시려면 추가 요금 있어요
대구에서 가려면 자가용차가 낫나요? 택시가 낫나요?	거리가 얼마 안 되니까 차 가지고 오시는 게 편하실 거예요
네, 성함이 어떻게 되세요?	김철수입니다
성인 한 분 맞으시나요?	저녁에 바비큐를 하고 싶은데요?
여기 혹시 후불도 가능할까요?	저희는 선불만 됩니다
텔레비전도 있고요?	방에 텔레비전 있어요
그래픽카드는 혹시 어떤거 사용하세요?	그래픽카드는 1060 이정도 사용하고 있어요
숙박 전에 짐을 보낼 수 있나요?	택배를 호텔로 보낼 수 있어요
회원은 얼마예요?	회원은 한 시간에 900원입니다
결제는 어떻게 도와드릴까요?	카드로 결제 되나요?
사장님 얼마 나왔어요?	만오백원이요
만원 정액권 카드로 발급해주시고 결제도 해주세요	현금 주시면 처리해드려요
네, 몇 분이신가요?	두 명입니다
방은 어떤 방으로 원하시나요?	너무 비싸지 않은 방으로 부탁드립니다
피씨방 영업시간이 어떻게 되나요?	저희 24시간 영업입니다
네, 예약하셨나요?	아고다로 했어요
늦게 갈 수도 있는데 몇 시까지 입장 가능한가요?	12시 전에 오시면 됩니다
네, 인원은 몇 명인가요?	성인 2명이요
같이 카드로 계산해주세요	함께 결제해 드릴게요
vip 룸인가요?	vip 룸이에요
포켓볼은 몇 개가 있나요?	2개가 있습니다
회원제로 운영되나요?	회원 및 비회원 모두 가능합니다
지금 영업 중인가요?	방금 개장했습니다
더블룸 예약 가능한가요?	더블룸 예약 가능하세요
포켓 다이 있나요?	현재 하나 비어있습니다
음식이나 음료도 주문 가능한가요?	피씨를 통해 주문 가능합니다
이따 다 같이 계산해도 되나요?	라면 값만 먼저 해주시면 됩니다
저녁에 바비큐 하려고 하는데 가능한가요?	준비해드릴게요
프린트값은 현금으로만 결제해야되는 거에요?	프린트값은 PC이용료랑 따로 계산하셔야 돼요
숙박비가 얼마인가요?	일반룸은 5만 원이고 스위트룸은 10만 원이에요
사장님 여기 흡연 가능한가요?	흡연구역은 따로 있습니다
아이들이 이용할 수 있는 편의시설이 있나요?	키즈클럽이 오십% 할인이 돼요
네. 퇴실은 몇 시에 하실 건가요?	내일 오후 12시 정도에 할게요
열 명 자리 있나요?	자리 금방 치워드릴게요
1박에 얼마에요?	1박에 4만 원이에요
자리에 삼발이 있나요?	밑에 보시면 있어요
당구대는 괜찮은가요?	저희는 벨기에산 당구대만 사용합니다
언제 이용하실 계획인데요?	4월 6일 정도요
몇 분이 이용하시나요?	정원이 초과되어 추가금이 있어요
짐 좀 방으로 옮겨주실 수 있나요?	18층으로 가져다 놓겠습니다
네 그럼 시간당 가격은 어떻게 되나요?	사용 요금은 시간당 7000원입니다
외부 음식도 시켜먹을 수 있나요?	주변에 추천해드릴수도 있어요
근처에 마트는 있나요?	걸어서 5분 거리에 농협 마트가 있어요
그럼 데바데 깔아주실 수 있나요?	깔아드릴게요
2박 예약 되나요?	침대 두 개 있는 방으로 안내해 드릴게요
금주 목요일 저녁 8시에 예약 가능할까요?	가능해요
오늘 남은 방 있나요?	3개 남아 있어요
비상구는 혹시 어느 쪽에 있나요?	비상구는 이쪽에 있습니다
와이파이 번호 있어요?	와이파이는 다 돼요
체크인하려고 하는데요?	102호로 가시면 돼요
당구장 영업시간이 어떻게 되십니까?	영업시간은 거의 1시부터 12시까지에요
결제 먼저 할게요	숙박비 10만 원 결제해드릴게요
장작을 구매할 수 있나요?	한 박스에 만 원이에요
대실과 숙박 중 어느 쪽인가요?	신분 확인을 위해 신분증 좀 보여주세요
초과 인원 있으면 이불 제공은 해주시나요?	그럼요. 이불 추가로 제공해드리겠습니다
혹시 자리에서 음식 주문이라든지 이런 건 할 수 있나요?	자리에서 음식 주문 가능합니다
게임비 카드 결제되나요?	됩니다
카드로 결제 가능해요?	물론이죠
체크인 해주실래요?	오션뷰 2박 예약하셨고 304호에요
이 방은 온돌방인데 괜찮으세요?	더 필요한 것은 프런트로 문의해 주세요
수영장 무료로 이용할 수 있나요?	수영장은 일박만 무료예요
컴퓨터 사양은 배틀그라운드 다 돌아가게 되어 있어요?	저희 컴퓨터들은 다 돌아게되어 있어요
5인실 쓸 수 있나요?	5인실은 가능해요
커플석 같은 거는 있어요?	커플석은 따로 없습니다
3명인데 저기 빈자리에서 하면 되나요?	빈 곳 아무 데서나 하시면 돼요
성함이 어떻게 되시죠?	전지현입니다
패밀리 A 숙소와 패밀리 B 숙소의 차이가 뭔가요?	패밀리 B 숙소는 침대가 2개이고 화장실이 하나예요
2박 하려고 하는데 가능할까요?	2박 가능하세요
카드로 결제되나요?	가능하지만 현금은 10% 할인됩니다
한진 룩으로 예약했는데, 확인 좀 해줄래요?	따라오세요
몇 번으로 갈까요?	12번으로 가시면 됩니다
헬스장 같은 경우에는 유료라고 하셨죠?	투숙객은 헬스장과 온천 사우나까지 하시면 만삼천원이에요
당구대가 괜찮네요	당구공도 벨기에산입니다
트윈으로 하면 애들하고 같이 잘 수 있을까요?	대학생이면 객실을 두 개 쓰셔야 해요
그러시면 성함이 어떻게 되시죠?	김성현입니다
2분이죠?	어른 2명이에요
지금 당장 숙박 가능한가요?	2인용 방 하나밖에 없어요
어떤 어플로 예약하셨어요?	야놀자로 예약했어요
다음 주 토요일 예약 가능할까요?	그 날 4명이 함께 머물 수 있는 숙소는 이미 마감되었어요
온돌방으로 있나요?	온돌방은 없어요
주말 요금이 얼마지요?	주말은 하루에 십육만 삼천삼백오십원이에요
이번 주 주말에 가능한가요?	금요일이랑 일요일 가능해요
펜션이 조용한가요?	집 한 채가 단독으로 분리되어 있어서 조용해요
성함이 어떻게 되세요?	김민지요
1인 추가 시 추가 비용은요?	4만 원이에요
어른 4명과 아동 2명, 총 6명이에요?	총 6명이에요
일회용품 하나 주실래요?	1000원이에요
얼마나 더 기다려야 되는데요?	약 15분 정도 더 기다리셔야 합니다
노래방 이용하려면 이용료가 얼마예요?	룸이 커서 단체로 하시면 1시간 3만원, 2시간에 5만원이에요
바비큐는 구성이 어떻게 되나요?	2인 기준 숯이랑 고기 400g같이 해서 4만 원이에요
몇 분 주무세요?	명 있을 방은 없어요\
공 교체 가능한가요?	가능합니다
요즘도 예약 많아요?	23일 18개 중 13개 예약되고 5개 남아있네요
카드 되죠?	카드 결제 되세요
아 그러면 펜션은 있고예?	숙박시설로 펜션이 있어요, 방이 여러 개라 단체로 묵으실 수 있는 휴양관도 있어요
외부 음식도 시켜 먹을 수 있나요?	짜장면 같은 음식은 가능하세요
1박에 얼마에요?	1박에 4만5천 원이에요
얼음 넣어 드릴까요	바로 가져다드릴게요
여수공항 말씀이세요?	여수공항이요
그것보다 조금 싼 방은 있나요?	8만 원짜리 방이 하나 있어요
방 있나요?	주말이라 확인을 좀 해볼게요
저희 예약한 방이 몇 층인가요?	15층, 오션뷰에요
이 카드로 계산해주세요	카드로 결제해 드릴게요
오늘 저녁 바비큐도 예약 했는데 확인 해주실래요?	이따가 시간 되면 내려오시면 돼요
인피니티 풀 마감시간은 어떻게 되나요?	오후 6시까지예요
여기 주차할 수 있는 공간은 있어요?	주차 공간은 없습니다
호텔 묵게 되면 편의시설은 어떤 거 이용할 수 있나요?	조식 있고 기본 어메니티는 객실에 다 채워져 있어요. 호텔 내에는 커피숍 있고 뒤쪽으로 관광지가 있어요
PC방에 6명이 같이 게임할 수 있는 룸이 따로 있나요?	있습니다
복층 펜션 있나요?	있어요
바비큐장 이용금액은 얼마인가요?	1인 만 원이에요
청소년들은 혹시 몇 시까지 이용이 가능한가요	청소년들은 오전 아홉시부터 밤 열시까지 이용 가능합니다
체크아웃은 몇 시인가요?	11시에 체크아웃 하셔야 해요
그럼 일단 일반석 앉을 테니 말씀해 주세요	2번째로 예약해 두겠습니다
몇 명이 이용할 실 건가요?	어른 4명요
여기 카드는 안되는가요?	카드 결제는 뒤쪽 포스기를 사용하시면 됩니다
다음 주말에 이용 가능한가요?	다음 주는 예약이 다 찼습니다
오늘 저녁에 바비큐 하려고 하는데 어디에서 할 수 있나요?	뒷마당에서 할 수 있어요
수영장 이용 가능할까요?	투숙객에 한해 사우나까지 무료로 이용할 수 있어요
카드 결제도 가능한가요?	카드 결제 가능하세요
회원분이신가요?	회원이 아니에요
체크인은 몇 시쯤이에요?	체크인은 두 시 이후부터 가능하세요. 두 시 이전에는 짐 보관도 가능해요
호텔에 다이렉트 예약을 하는 게 저렴한가요? 아니면 호텔 예약사이트가 저렴한가요?	사이트가 특가상품으로 나오는 게 있어서 더 저렴하실 거예요
몇 시간 있을 수 있나요?	오후 5시까지 이용하실 수 있어요
혹시 중국집 배달되나요?	배달됩니다
사이트는 어디로 해드릴까요?	A 구역 15번이요
제 예약이 왜 취소가 된 겁니까?	태풍으로 인해 오는 길이 폐쇄된다고 연락을 받았어요
예약하신 분 성함이 어떻게 되시죠?	유해진입니다
자스민 방은 침대방인가요? 온돌방인가요?	자스민은 복층에 침대 있는 방이에요
음식 주문 가능한가요?	자리에 있는 메뉴판 보시고 주문하시면 됩니다
5인실로 예약 되나요?	5인실로 예약 해드릴게요
혹시 와이파이는 설치되어 있나요?	와이파이 있습니다
체크인 시간보다 일찍 오셨네요?	가능해요
여기 주차 할 수 있는 시설은 있을까요?	주차 할 수 있는 시설이 있습니다
기본적으로 비품은 뭐 어떤 게 준비되어 있어요?	객실 안에는 칫솔, 치약, 면도기, 샴푸, 린스, 보디워시, 보디로션, 물 두 개가 있어요
일주일 씩 있는데는 금액이 어떻게 해요?	일주일씩 계시면, 하루 이만원이에요
식당은 대인 같은 경우에는 금액이 어떻게 되나요?	식사가 콩나물 전문점이라 연령에 따라서 금액이 매겨지지는 않고, 메뉴 기본이 육천 원부터 시작이에요
사장님 와이파이 되나요?	와이파이 비밀번호는 카운터에 붙여져 있어요
밖에서 음식 사와도 되나요?	죄송하지만 외부 음식은 반입금지입니다
예약확인 하려면 어떤 내용이 필요한가요?	성함을 말씀해주시면 돼요
바로 나오나요?	제가 조리해 드려요
그럼 컬러로 뽑으려는데 어디에서 하면 되나요?	3번이나 5번 자리가 프린트가 가능하니 편하신데 앉으세요
아 혹시 프린트만 할 건데 컴퓨터 사용 요금도 따로 있나요?	프린트하시는 분은 기본적으로 15분 무료고 추후에 요금은 시간당 1000원 이에요
언제까지 체크인하면 되나요?	오후 3시부터 체크인 가능해요
방에서 담배 냄새가 너무 심한데 조치해주실래요?	손님 바로 확인 후 조치 해드릴게요
혹시 영업시간이 어떻게 되나요?	24시간 영업합니다
네 음료는 따로 사 먹어야 하나요?	알겠습니다
그럼 4구 주세요	알겠습니다
이용요금은 10분에 얼마인가요?	대대는 1700원이고 중대가 1300원이요
공항과 가까운 호텔로 예약해주실 수 있나요?	예약해드릴게요
흡연실도 다 마련이 되어 있나요?	흡연실도 저쪽 보시면 있습니다
PC방 영업시간이 언제까지 인가요?	영업시간은 24시간이에요
프린트 가능 PC를 다른 분이 사용 중이신데 다른 PC는 없나요?	그럼 카운터에 있는 PC를 사용하세요
카드로 결제 되나요?	감사합니다
사월 십삼일 주말 일박 이일로 예약 가능한가요?	주말 온돌방은 예약이 끝났고 침대방은 예약이 가능하세요
요금은 한 시간에 얼마에요?	한 시간에 900원이에요
몇 분이신가요?	성인 네 명 아이 두 명입니다
몇 시부터 입실인가요?	2시부터 가능해요
방을 인터넷에서 보셨어요?	방은 저희가 바빠서 보지는 못했는데
성인 둘 아기 한 명이 사용할 스위트룸 있나요?	스위트룸 자리 있어요
체크인 시간이 어떻게 되나요?	세 시 입실이고 열두 시 퇴실이에요
네, 두 개 드릴까요?	하나만 주세요
두 분이신가요?	예약하고 왔거든요
불판은 파나요?	하나에 만 원이에요
조금만 상의 더 하고 다시 전화드릴게요	전화 주세요
흡연실은 어디 있나요?	피시방에 흡연실은 따로 없습니다
주말에 가려고 하는데 예약할 수 있나요?	예약 도와드릴게요
식사도 주문할 수 있습니까?	라면같이 간단한 것은 가능합니다
자리로 갖다 주나요?	조금만 기다려주세요
음료나 커피는 셀프예요?	가져다드릴게요
장기는 그러면 한꺼번에 결제를 해야하나요, 아니면 하루하루 해야하나요?	한꺼번에 해야 해요
내일 몇 시에 체크아웃이죠?	체크아웃 시간은 오전 11시에요
조식은 한식으로 되나요?	조식은 한식으로 할 수 있어요
호텔에 편의시설이 있나요?	편의시설은 레스토랑, 사우나, 피트니스, 편의점 이렇게 사용이 가능하세요
컴퓨터 사양은 어느정도 인가요?	사양은 왠만한 게임 다 돌아가는 정도라고 생각하시면 돼요
계산은 카드로도 가능한가요?	현금, 카드 다 가능해요
언제쯤 방문 예정이세요?	오월 오일쯤이요
혹시 일하는 사람들 데리고 장기 투숙 한달 정도 이용할 수 있는 방이 있나요?	침대 2개 있는 방은 있어요
300 넘게 치는데 마쎄이 해도 되나요?	기물 파손은 안됩니다 손님
몇 박 하실 거예요?	1박에 5만 원이에요
화요일 맞으시죠?	삼월 이십육일 화요일이에요
체크인하고 체크아웃 시간은 어떻게 돼요?	세 시 입실이고 열두 시 퇴실이에요
확인 결과 두 호텔 예약 가능하신데 따로 원하시는 조건이 있으신가요?	한 호텔은 공항과 아주 가까워요
청소년들은 혹시 몇 시까지 이용이 가능 한가요?	청소년들은 9시부터 10시까지 이용 가능합니다
그럼 프린트 누르고 찾으러 가면 될까요?	프린트 누르시고 오셔서 결제하시면 됩니다
볶음밥 두 개만 바로 주문할게요	죄송한데 볶음밥은 메뉴에 없어서
음료 마시다 키보드에 좀 쏟았는데 어쩌죠?	지금 치워드리겠습니다
퇴실 시간은 언제죠?	오전 11시예요
비회원도 사용할 수 있어요?	비회원도 물론 사용 할 수 있습니다
주차는 가능한가요?	주차는 밑에 보시면 옆 건물 주차장이 있어요
스탠더드 더블룸 맞으십니까?	13층 객실로 해드렸어요
치약, 칫솔도 다 있어요?	치약은 있는데 칫솔은 없어요
흡연실은 따로 있어요?	흡연실은 따로 있습니다
4인실에 욕조 있나요?	4인실에 욕조가 딸려 있어요
대구에서 경주지역에 펜션이용하려고 하는데 위치가 어디쯤인가요?	저희 펜션은 동쪽 바다 바로 앞에 있어요
커플석 자리도 있나요?	있습니다
십칠만 원에 조식도 포함되는 비용인가요?	조식은 별도에요
직접 전화하는 게 가격이 더 낫겠네요?	계좌이체를 하시면 나중에 할인이 좀 돼요
저번 주에 예약했는데 확인해주실 수 있나요?	정상 예약되셨어요
대실이신가요, 숙박이신가요?	숙박하려고요
음료 한 잔씩 드리는데 뭘로 드릴까요?	잠시만요
몇 분이신가요?	두 명이요
계산은 카드도 가능한가요?	카드로 계산 가능하세요
흡연실은 어디 있어요?	흡연실은 저기 제일 끝에 있습니다
몇 명 정도 오시나요?	6명 정도 가는데요
로그인 카드 가져갈게요	감사합니다
체크인 시간보다 일찍 오셨네요?	혹시 체크인 시간이 아니긴 하지만 짐을 맡겨 놓을 수 있을까요?
그룹 당 가격인가요?	사람 한 명 당 가격입니다
여기 짜파게티 컵라면이 얼마에요?	1500원입니다
산호 룸은 바다가 보이는 방인가요?	바로 코앞이 바다입니다
비상구는 어느쪽에 있어요?	끝에 두 군데 있고 출입구 옆에 한 군데 이렇게 있어요
회원가입하고 싶어요	저쪽 컴퓨터에서 직접 회원가입하시면 됩니다
포켓볼 다이도 있나요?	있습니다
제휴 카드 같은 거는 없고요?	제휴 카드는 따로 없어요
몇 시에 퇴실하면 되나요?	4시간 뒤에 퇴실하시면 돼요
화장실은 어느 쪽으로 가야 하죠	pc방 나가셔서 건물 왼쪽으로 가시면 됩니다
몇 번 자리로 가면 되나요?	빈 곳에 앉으시고 카드번호 눌러주세요
영업시간이 어떻게 되나요?	저희는 24시간 영업합니다
당구 배울려면, 당구장에 매일 와야 돼요?	그래야 진도가 빠르죠. 학교 갔다가 될 수 있으면 빨리 오면 좋죠
사월 육일 일박 이일로 예약이 가능한가요?	사월 육일 일박 이일 가능하세요
자스민은 이용 요금이?	자스민은 15만3천원이에요
가족인데도 한 방에 네 명이 못 묵나요?	고객님, 객실 자체가 아주 좁으세요
주차 시설은 구비되어 있나요?	주차장도 넓게 준비되어 있어요
신용카드의 사용은 가능한가요?	현금으로 가능한 물품 및 일부 점포를 제외하고 사용 가능해요
시티뷰나 오션뷰 중에서 어떤 방을 원하시나요?	오션뷰로 해주세요
프린터 사용 가능한가요?	가능합니다
계산은 카드로도 가능한가요?	카드로 계산 가능합니다
와이파이는 혹시 다 설치가 되어있어요?	와이파이는 다 설치되어 있습니다
바다 뷰로 이용 가능한가요?	바다 뷰일 경우 금액 추가되 실수 있어요
인 당 추가 금액은 얼마인가요?	인당 만 원씩입니다
혹시 피씨방 영업 시간이 언제까지 인가요?	24시간 영업입니다
바비큐 시설 이용료는 얼마인가요?	2만 원이에요
바비큐 고기는 저희가 준비해야 하나요?	고기랑 채소는 직접 준비해 오셔야돼요
룸에서 배달음식 시켜서 먹을 수는 있어요?	저희가 외부 음식은 반입이 금지예요
친구랑 둘이서 펜션 이용하려고 하는데 주말에 빈자리가 있나요?	주말에 방 있어요
네 컬러 인쇄도 가능한가요?	흑백은 50원 컬러는 100원입니다 필요하신 프로그램이 있나요?
몇 분이 이용하시는 거예요?	성인 두 명과 아이 두 명이요
카카오페이나 삼성페이도 가능하신가요?	카카오페이랑 삼성페이 둘 다 결제 가능하세요
사장님, 깎아주시면 안 돼요?	토요일은 할인 안 돼요, 무조건 다 예약이 되어서요
숙박 인원이 4명인데 디럭스룸이 좋을까요 VIP 룸이 좋을까요?	인원 4명 숙박인 경우 VIP 룸이 더 나아요
그릴 사용료가 얼마입니까?	2만 원이에요
특실과 일반실의 차이점이 뭔가요?	내부 시설과 방 넓이에 차이가 있어요
조식 포함인가요?	조식은 불포함이에요
5천원 충전해주세요	충전은 카운터 앞 기계 사용하시면 충전 가능합니다
방 있나요?	그럼 4인실로 안내해 드릴게요
컴퓨터 사양은 베틀그라운드라던지 그런거 돌아가나요?	베틀그라운드 돌아갑니다
뷰 좋은 룸을 예약하려면 숙박비는 얼마나 드나요?	트윈 베드 하시면 사십삼만삼천삼백원이에요
헤드셋은 자리에 다 비치되어 있나요?	자리에 보시면 있어요
장기 투숙 가능한가요?	장기투숙 가능해요
조식 이용 가능하죠?	8시까지 이용하실 수 있어요
결제는 신용카드와 현금 중 어느 걸로 하시겠어요?	신용카드로 결제하겠습니다
방은 온돌방이죠?	바닥은 개별난방이고 침대는 복층, 이층에 있어요
내일 아침 7시에 모닝콜 해주실래요?	오전 7시에 모닝콜 드릴게요
세면도구 같은 거 있나요?	세면도구는 준비되어 있어요
어른 한 명당 추가로 돈을 내야 하는 거죠?	추가로 만 원씩 붙어요
배달음식 시켜 먹어도 되나요?	시켜드셔도 돼요
현금이 없는데 그럼 어떻게 결제하나요?	계좌이체로 해주셔도 됩니다
흡연실 어디 있어요?	흡연실은 밖에 나가시면 돼요
4인 가족 기준 얼마인가요?	1박에 20만 원이에요
당구는 한 시간에 얼마죠?	육천 원입니다
얼마예요?	1박에 5만 원이에요
시간당 게임비는 얼마죠	중대 기준으로 시간당 1500원입니다
포켓볼 치려고 하는데요	포켓볼은 한 시간에 15000원입니다
나올 때 방에 두고 오면 되나요?	빌리신 충전기는 퇴실하실 때 열쇠와 함께 반납해주세요
혹시 프린트는 가능 할까요?	프린트 가능합니다
체크인 아웃은?	6시 넘어서 오시면 되고, 체크아웃은 12시에서 1시 사이면 돼요
2시간 이용대금 얼마예요?	2만 원입니다
총 6명인데, 방 개수는 하나로 하고 싶은 데 될까요?	4인 방에 2인 추가 요금 내시고 쓰면 됩니다
마감시간이 정해져 있지 않나요?	손님이 있을 때는 계속 운영해요
계산은 카드로 가능한가요?	카드로도 결제 가능하세요
당구장 안에서 담배 피워도 되나요?	흡연실 따로 있으니까 거기서 부탁드려요
청소년들 이용시간은 몇 시 까지에요?	청소년들은 저녁 10시부터 아침 9시까지는 못 들어와요
네, 몇 인분 필요하세요?	준비되면 방으로 전화드릴게요
다음 주 주말로 예약해도 되나요?	지금 예약해 드릴게요
한 시간에 얼마예요?	3000원입니다
오늘 한 명 더 추가 인원이 생겼는데, 어떻게 하나요?	약하신 방 정원이 4명까지라서 한 분 더 들어가시면 2만 원 추가 비용 있어요
이번 주 토요일 밤 예약 가능할까요?	이번 주 토요일로 예약 가능해요
주차비는 따로 없나요?	편하신 곳에 주차하시면 돼요
네 다음에 올게요	안녕히 가세요
계산은 각자 할 수 있나요?	각자 계산해드릴 수 있어요
컴퓨터 사용 가능한가요?	컴퓨터 사용 가능해요
결제는 카드로 하겠습니다	카드 결제 되셨네요, 방 열쇠 여기 있어요
그리고 11번 자리에 2시간 추가해주세요	그리고 두 시간 추가해드렸어요
하루에 얼마인가요?	8만 원이에요
여기 혹시 예약도 가능한가요?	단골분들은 연락 오시면 예약석 지정해드리고 있습니다
회원가입 안하고도 이용할 수 있나요?	후불카드나 선불기계 사용하시면 돼요
야외 바비큐장 있나요?	야외 바비큐장은 추가요금을 주시면 사용 가능해요
당구 종류는 어떻게 되어 있나요?	식스볼하고 나인볼이 있어요
조금 생각을 해보고 다시 전화드리도록 하겠습니다	전화 주세요
주위에 볼만한 관광지가 있나요?	우리 집에서 아쿠아리움 예약하시면 가격이 저렴하고, 관광지는 10분 거리에 있어요
삼월 이십일 예약 가능한가요?	삼월 이십일은 예약 가능해요
트윈은 다 싱글 베드인가요?	트윈은 싱글 베드만 있어요
음료수는 무료인가요?	무료고 제가 가져다드릴게요
카드 결제할게요	카드 결제해 드릴게요
어떤 거 하실 거예요?	포켓볼이요
앞으로 몇 시간 사용 가능한가요?	5시간 이용 가능하십니다
다리미는 어디서 빌릴 수 있나요?	방에서 전화기로 알려주시면 저희가 보낼게요
네 명 갈 건데, 어른이 두 명 더 가면 추가료 더 받나요?	오인 기본에 추가 인당 만 원씩이니까 두 분이 더 오시면 만 원 추가돼요
9인실은 가격이 어떻게 되나요?	숙박료는 1박 2일 기준 18만 원이에요
회원가입할게요	가입시켜드리겠습니다
조식이 없으면 어떻게 해요?	주위에 괜찮은 식당이 많으니 이용하시면 돼요
네 어떻게 주문해드릴까요?	탕수육 세트에 자장면 추가로 주문해주세요
인원이 어떻게 되시죠?	아이 한 명 추가 요금 있어요
대실도 가능한가요?	숙박만 가능해요
체크인이 언제까지예요?	11시까지 체크인하시면 돼요
토요일에 오실 건가요?	4월 13일 토요일에요
혹시 주차할 공간은 따로 있어요?	주차공간은 따로 없습니다
네. 퇴실은 몇 시에 하실 건가요?	방 안내해 드릴게요
커피숍 이용 시간은 몇 시부터 몇 시까지예요?	커피숍은 아침부터 밤 정도까지 해요
오늘 꼭 온돌 룸에서 묵어야 하면요?	온돌 룸은 내일부터 투숙이 가능하세요. 아니면 패밀리 트윈 객실이 싱글 침대 하나랑 더블 침대 하나 들어가는 객실이 있어요
원하는 자리에 앉아도 되나요?	자리 잡고 아이디에 자리 번호 입력하세요
선불로 밖에는 안되는 건가요?	회원으론 선불로만 가능하시고 비회원은 후불로도 되세요
오션 뷰 쪽으로 원하시는 거예요?	바다가 보였으면 해요
음식 주문하는 것도 괜찮은가요?	자리에서 음식 주문해주시면 됩니다
예약 안 하셨나요?	지나가다가 보고 들어왔는데요
세면도구는 두 개 주세요	여기 세면도구 2개 받으세요
한 시간에 얼마죠?	1000원입니다
비흡연실인가요?	그렇습니다
컴퓨터 사양이 배틀그라운드 같은 거 돌아갈 수 있는 사양인가요?	배틀그라운드 렉 없이 잘 돌아갑니다
여기 혹시 이용시간이 언제까지 인가요?	성인은 24시간 이용하실 수 있으세요
딸하고 두 명 일박하는 데 얼마 들까요?	저희 하이 디럭스가 디럭스 더블보다 고층이라서 바다 쪽이 더 잘 보이는데 이십삼만원이에요
애들 아빠랑 상의를 한 번 해보고 전화할게요	확정되면 전화 주세요
음식은 뭐 어떤게 있을까요?	음료부터 식사까지 다양하게 있습니다
네 4명이요	5번 자리로 가세요
거기 주소 좀 알려주시겠어요?	문자로 보내드릴게요
주차 할 곳은 있나요?	주차타워가 있어서 주차가 가능하세요
네, 현금으로 결제하시나요?	카드로 결제해 드릴게요
이불 한 장 더 주실 수 있나요?	방으로 가져다드릴게요
할인된 가격인가요?	저희 기존의 가격에서 할인된 가격으로 판매하고 있어요
카드로 할게요	카드로 4만 원 결제해 드릴게요
캠핑장 위치가 어디인가요?	의왕 호수 옆 주차장으로 오시면 돼요
다른 서비스는 또 추가 지불해야 하나요?	수영장 이용비만 따로 있어요
여기 4구밖에 없나요?	저희 당구장은 포켓볼도 합니다
결제는 카드로 하시나요?	문자로 계좌번호 보내드리겠습니다
포캣볼이랑 삼구랑 사구랑 다 있어요?	모두 구비가 되어 있어요
음료 주문 가능한가요?	자리에서 PC로 음료 주문 가능합니다
프린트 사용 가능한 PC가 있나요?	왼쪽 끝에 프린트라고 적힌 PC에서 프린트 가능합니다
삼월 이십팔일 예약 가능한가요?	디럭스 더블 바닷가 전망 객실 가능하세요
컵 좀 주시겠어요?	컵은 셀프로 가져가시면 됩니다
패밀리룸은 침대가 2개인가요?	베드 1개에 온돌 침구 1채가 제공돼요
혹시 커플석 있어요?	커플석은 없습니다
음식 주문도 가능한가요?	라면이랑 볶음밥 몇 종류 있습니다
체크인 시간은 몇 시고 체크아웃 시간은 몇 시인가요?	체크인은 오후 세 시부터이고 체크아웃은 다음 날 열한 시까지예요
번개탄말고 숯 주세요	거기에 고기 구워드시는 분 많아요
카드로 결제 되나요?	감사합니다
시간당 얼마인가요?	1900원입니다
순두부마을 아세요?	쉽게 찾아갈 수 있도록 설명해주시면 좋은데
생수나 타월 등은 준비되어 있나요?	모두 준비되어 있어요
외부음식도 시켜서 먹을 수 있나요?	시켜서 드실 수 있습니다
성함 말씀해주세요	강호동이고 6명 예약했습니다
오늘 밤 3명 숙박 예약 가능할까요?	예약해드리겠습니다
주중 날짜 예약은 아직 가능하세요. 정확한 날짜를 확인해주시겠어요?	사월 일일부터 오일 사이요
여기 사장님은 전문적으로 안 가르쳐주세요?	여기는 전문적으로 가르치지 않아요
두 명이시죠?	저희는 두 명이에요
좀 더러운 것 같은데 좀 닦아주세요	닦아드릴게요
자가용으로 이동하는 게 쉬울까요?	자가용으로 큰길에서 2분 정도 올라오시면 돼요
거기 가족끼리 4인 묵일 수 있는 방이 있나요?	파티룸이라고 있어요
마운틴뷰와 시티뷰 중에 어떤 걸로 드릴까요?	시티뷰로 부탁드릴게요
지금 빈 방이 있나요?	지금 방이 몇 개 안 남았어요
30분만 할 수 있나요?	됩니다
몇 명이신가요?	여섯 분이 쓰실 만한 큰 방 있어요
자리 번호가 어떻게 되세요?	5번입니다
가격대는 어떻게 되나요?	일반 룸은 5만 원, 디럭스 룸은 7만 원이에요
달방 한 달로 해주세요	한 달 사용으로 해드릴게요
인원 추가 시 추가 금액이 있나요?	5명 이상이면 인당 만원 추가 되세요
체크인 체크아웃 시간은 몇 시입니까?	체크인은 16시 체크아웃은 10시예요
장갑은 세탁이 다 되어있는 건가요?	저희는 사용 후 항상 세탁을 합니다
오월 칠, 팔, 구 일에 갈 예정인데 가족 단위로 갈 수 있는 방이 있나요?	저희가 예약식이라서 보신 펜션을 말씀해주시면 안내를 해드릴게요
혹시 요금은 한 시간에 얼마 정도 하나요?	비회원은 한 시간에 1000원이고 회원은 한 시간에 8백원입니다
몇 명이시죠?	성인 2명요
삼성페이나 카카오페이도 결제 가능한가요?	카카오페이는 결제가 안될거에요
짜장면 주문해주시나요?	가능합니다
무슨 방으로 예약하셨나요?	라벤더 방입니다
음식 주문도 가능한가요?	음식 주문도 가능합니다
오늘 예약하고 싶은데 방 있나요?	방 있어요
그런데 이따 카드 결제돼요?	가능한데 카드는 10% 추가된 요금으로 받습니다
트윈 룸 남는 방 있나요?	바다전망이니 마음에 드실 거예요
현금영수증 되나요?	발급 도와드릴게요
음료 주문 가능한가요?	옆 냉장고에서 꺼내오시면 됩니다
뷰가 조금 좋은 방도 있나요?	호숫가 전망으로 하신다면 십육만 원에서 이십만 원대 사이로 가능하세요
방 요금은 얼마인가요?	5인 기준 8만 원이고 1인 추가 당 3만 원 총 11만 원이에요
흡연실은 따로 있어요?	흡연실은 따로 있습니다
방이 몇 개인가요?	세개에요
더블베드의 두 침대는 싱글사이즈인가요?	하나는 싱글이고 하나는 더블이에요
재떨이 필요하세요?	재떨이 새 걸로 주세요
포켓볼도 있나요?	있습니다
당구대가 괜찮네요	관리를 잘하시네요
금요일, 토요일 이틀은 예약이 불가능한가요?	금요일만 가능해요
숯도 올려주시나요?	숯 올려드리는데 이만 원 받고 있어요
바비큐를 해 먹으려면 따로 비용이 추가로 드나요?	이만 원인데 만 원만 받을게요
번호 입력하고 결제는 어떻게 하면 되나요?	선불카드 충전하셔서 이용하시면 됩니다
PC방 영업시간이 24시간인가요?	24시간 영업합니다
호텔 내에 컴퓨터나 전자레인지 같은 건 있나요?	전자레인지는 옆에 레스토랑에 있고, 세미나실에서 간단한 컴퓨터 작업을 하실 수 있어요
펜션에 바비큐장 말고 다른 거는 없죠?	펜션에 다른 건 없고, 준비해오셔야 해요
여기 청소 좀 해주세요	바로 갈게요
평일 예약하면 조금 할인되는 부분이 있나요?	평일 예약해도 크게 할인은 없어요
디럭스룸이랑 스위트룸의 가격 차이가 얼마나 나나요?	스위트룸이 디럭스룸보다 5만 원 더 비싸요
저기 맞은편 빈자리 앉을 수 있나요?	감사합니다
먹을 것도 판매하나요?	한식부터 중식 외 다양한 간식 준비되어 있습니다
일반실은 5만 원이고 특실은 8만 원인데, 어느 방으로 드릴까요?	특실로 할게요
어느 정도 기다려야 할까요?	15분이면 자리 날 듯합니다
당구장 밑에 주차해도 괜찮죠?	괜찮은데 차 앞에만 주차하지 마세요
혹시 프린트도 가능한가요?	이용하다 궁금한 거는 채팅으로 물어보세요
주위에 볼만한 곳은 있나요?	주위에 돌산 공원, 오동도, 엑스포 아쿠아리움, 낭만포차 등이 15분 거리 내에 있어요
펜션 안에 냉난방은 잘 되나요?	잘 돼요
지하주차장 넓나요?	지하주차장이 2층 3층 있으니까 충분하실 거에요
혹시 피씨에서 음식 주문도 가능한가요?	자리에서 음식 주문 가능합니다
네, 금요일 몇 분인가요?	2명이고요
콜라 하나 먼저 주세요	이따가 같이 계산해 주세요
할인은 안 되나요?	그럼 할인해서 총 20만 원에 해드리겠습니다
조식도 주시나요?	조식은 드려요
카드도 되나요?	가능합니다
공휴일에도 다 영업 하시나요?	휴일에도 하는데 가게마다 달라요
게임당 얼마인가요?	10분당 1500원입니다
다이가 조금 더러운데 치워주시겠어요?	음료 드시시고 계시면 금방 치워드리겠습니다
아침식사 가능 한 곳있나요?	7시 반에서 9시 사이에 조식 있어요
여기 후불로 이용해도 되나요?	후불은 안되고 모두 다 선불로만 이용 가능하세요
가족끼리 사인이 묵을 수 있는 방도 있어요?	사인이시면 파티룸이라고 있어요
불판을 교체 할 수 있을까요?	오늘 고객님들이 너무 많아 현재 여유 불판이 없네요
아까 그 방으로 주실래요?	결제 도와드릴게요
성함이 어떻게 되시나요?	정우성입니다
네 그럼 이따 계산할 때 계좌번호 알려주세요	알겠습니다
숙박비는 얼마인가요?	하루에 4인 기준 50만 원이고, 인원 초과 시 1인당 2만 원이에요
PC방 한 시간 요금은 얼마에요?	한 시간 십분 정도에 1000원이요
매점에서 술도 파나요?	맥주와 소주 팔고 있어요
후불로 이용할 수 있나요?	선불로 먼저 결제를 하셔야 컴퓨터를 사용하실 수 있어요
성함이 어떻게 되세요?	하재현이요
간단한 음식을 먹을 수 있나요?	여기서 구입할 수 있습니다
객실이 몇 층에 있지요?	객실은 5층에 있어요
숙박비는 지금 지불해야 하나요?	퇴실하실 때 지불하시면 돼요
취사도구는 다 있어요?	취사도구는 다 깨끗하게 바비큐장 바로 앞에 있어요
배달 책자 하나만 주세요	여기 있습니다
포켓볼 다이는 없나요?	두 테이블에서만 가능합니다
조식 포함되나요?	1인당 5천 원 추가돼요
네 예약 알림 서비스가 있는데 신청하시겠어요?	문자와 통화로 가능해요
젓가락  한 개만 더 주세요	여기 있습니다
네, 오늘 체크인하시고 체크아웃은 언제로 잡아드릴까요?	내일이요
계산은 카드로도 가능한가요?	카드로 가능하신데 현금으로 하시면 할인이 들어가는 행사 중에 있어요
회원 요금이에요?	회원가입하시면 800원입니다
일반 스탠다드룸 말씀하시는 건가요?	룸이 어떤 게 있는지 여쭤보는 거예요
여기 생긴 지 얼마나 되었나요?	5년 되었습니다
3명이 들어갈 시 추가금이 붙나요?	삼만 원의 추가요금이 있어요
오늘 남는 방 있나요?	방 있어요
원룸 복층으로 큰 방 있는데, 오시는 날짜가 언제이세요?	주말, 한 23일에 1박 2일로 가려고 하거든요
여기 현금인출기가 따로 있나요?	옆 건물에 은행이 있습니다
음식 주문같은 거 다 가능한가요?	저희는 아직 음식 주문 안하고 있습니다
1시간에 얼마인가요?	비회원 시간당 1200원입니다
저녁에 친구들이랑 올껀데 예약은 안되나요?	약은 하지 않고 있습니다
사구 있나요?	물론이죠
텐트, 한 동 치는데 얼마에요?	텐트 치면, 큰 거는 삼만원 작은 거는 이만원이요
회원가격인가요?	일반 사용자 가격입니다
주차시설은 있어요?	여기는 없어요
의논 한번 해보고 다시 연락드릴게요	꼭 전화주세요
당구장 영업 시간이 몇 시까지에요?	여기 24시간이에요
가능은 하신데, 카드 결제하신다는 말씀이죠?	카드 결제하려고요
1시간에 1500원 맞죠?	회원이시면 시간당 1500원입니다
결제 현금으로 할 건데 현금영수증 해주세요	현금영수증 받으세요
몇 분이신가요?	3명입니다
디자인 아트 룸 있습니까?	거울로 꾸며진 럭셔리룸이 남아 있어요
그 부근에 대게 파는 곳은 많죠?	대게 파는 곳 많아요
조식비는 얼마를 지불해야 하죠?	조식은 현금 팔천원, 카드는 팔천 팔백원이요
혹시 장갑도 빌릴 수 있나요?	대여 가능합니다
혹시 프린트도 가능한가요?	프린트하려면 A 라인 자리에 앉아서 하세요
이틀 숙박할게요	이틀 숙박은 안 되세요
기본 4명에 4명 더 추가해서 예약 진행해 주실래요?	예약해드릴게요
예약자분 성함 알려 주실래요?	밤정연이에요
제 자리에 달아주세요	2시간 추가에 라면과 계란까지 총 4500원 12번 자리에 달아드렸어요
사구로 주시고, 커피 서비스 주세요	가져다드릴게요
복층방은 몇 명까지 입실 가능한가요?	최대 성인 4~5분까지 가능해요
취사 시간은 정해져있나요?	따로 정해져 있지 않지만 고성방가는 다른 손님들께 피해가 되니 그 부분만 조심해 주세요
조식이 포함된 가격인가요?	저희는 따로 조식 서비스는 없고 숙박만 가능해요
미리 예약을 걸어 놓을 수 있나요?	대기라는 게 따로 없고 당일날 취소하시는 분이 있을 경우에만 가능하세요
두 자리 있나요?	이쪽 끝자리 사용하세요
지금 숙박 가능한 방 있나요?	숙박하실 방 있어요
바비큐는 어디서 하면 되나요?	저쪽 마당에서 가능해요
여기는 비용이 어떻게 돼요?	10분에 2000원이에요
몇 분이 이용하실 건가요?	5명이 이용할 겁니다
수영장 이용 비용은 얼마인가요?	4분 중 아동 2분은 무료이고 성인은 1인 만 원이에요
호텔 라운지는 무료로 이용할 수 있는 거죠?	무료로 이용 가능하세요
관광은 도보로 안 되죠?	관광지는 차로 가셔야 해요. 바다에 가시려면 무료로 가이드 카트라고 전동버스가 있어요
비상구는 어느 쪽에 있나요?	비상구는 여기 밖에 없어요
청소년들 이용은 몇 시까지에요?	청소년들은 10시까지 이용 가능하세요
대중교통 이용도 가능한가요?	지하철에서 가까워서 대중교통을 이용하셔도 편리해요
그럼 그냥 가입 안 할게요	두 시간에 2천 원입니다
여기 펜션이 강원도 춘천시에 위치한 곳 맞나요?	맞아요
3명 예약하려는데요?	2인 기준 방으로 준비해드릴게요
알겠습니다, 고민해보고 다시 전화드리겠습니다	전화 꼭 주세요
제가 예약한 텐트는 몇 번 텐트인가요?	3번 텐트에요
매점은 몇 시까지 운영하나요?	10시까지 운영하는데 만약 문 닫혀있으면 이쪽으로 전화 주세요
추가 인원 안 되나요?	저희는 추가 인원은 받지 않아요
조미료 같은 거는 없나요?	조미료는 구비되어 있어요
어디가 맛있어요?	중화가 짜장면이 유명합니다
그럼 다른 자리로 주세요	여기 한자리와 저쪽 한자리 쓰시면 돼요
카드 결제되나요?	가능합니다
결제 카드로 가능한가요?	현금하고 카드 다 가능합니다
이번 주 토요일에 1박 하고 싶은데 예약될까요?	가능해요
정액제도 있나요?	있습니다
사우나 있다고 하셨는데 언제 이용이 가능해요?	사우나는 여섯 시부터 여덟 시까지 이용이 가능하세요
몇 시까지 하시나요?	오후 10시까지 합니다
저희 그럼 어느 자리로 갈까요?	왼쪽 두 번째로 가세요
오늘 주무셔야 되죠?	오늘부턴 아니고
바비큐는 직접 구워주시는 건가요?	정해진 시간에 바비큐 파티가 열립니다
조식 시간은 몇 시인가요?	오전 6시부터 9시까지예요
복층 방은 침대가 있어요?	이층에 침대가 있고 일층은 온돌이어서 난방이 되어 주무실 수 있어요
혹시 계산은 카드로도 가능한가요?	카드 계산 됩니다
글램핑 예약하려는데, 어떻게 해야하나요?	죄송하지만, 다음 주는 금요일부터 토요일까지 시간 밖에 없어요
단무지는 안주 시나요?	단무지도 가져다드릴게요
방 안에서 음식을 만들어 먹어도 되나요?	숙박하고 계신 방은 요리를 해도 되는 방이여서 가능해요
정액제 가능한가요?	가능합니다
아침은 주나요?	아침은 알아서 드셔야 해요
룸서비스 번호 몇 번인가요?	1234예요
1시간당 요금이 얼마인가요?	1시간에 1000원입니다
아 여긴 열선 다이가 아닌데요	그럼 4번 써주시고 요금 조금 추가됩니다
마세 쳐도 되나요?	300이하는 곤란합니다
방은 평수가 대충 어떻게 돼요?	스탠더드 더블룸이 제일 작은 방인데 칠 평 정도이고, 디럭스 트윈은 더블 침대 두 개 있는 객실인데 열 평 정도네요
그럼 사용 시간은 언제 퇴실해야 되고, 입실하고, 시간은 있을 거 아니예요?	입실은 오후 세 시부터 가능하시고요, 퇴실은 다음 날 열두 시까지예요.
자리에 가서 그냥 사용하면 되나요?	무인 기계에서 사용하실 시간과 금액을 정해주시면 됩니다
당구대가 흔들거려요	불편했던 점 사과드립니다
여기 피씨방 영업시간이 어떻게 되세요?	24시간 영업입니다
8인실로 예약 가능한가요?	8인실은 예약 가능해요
고기 구워 먹으려면 어떻게 해야 하나요?	이쪽 테라스 공간을 이용하시면 돼요
포켓볼 한 팀이랑 사구 한 팀 자리 있나요?	포켓볼은 10분 기다려야 하고 사구는 저쪽 테이블 쓰시면 됩니다
음식도 판매하나요?	간단한 조리식품이랑 음료 판매하고 있습니다
네 담배 피워도 되나요	화장실 옆에 흡연실 있습니다
가능한 높은 층으로 예약 가능할까요?	꼭대기 층으로 예약 도와드릴게요
전자레인지나 컴퓨터가 구비되어 있나요?	컴퓨터는 있지만, 전자레인지는 없어요
두 명 가격인가요?	한 사람당 5천 원이에요
네. 대략 몇 시간이나 이용하실 예정이세요?	글쎄요 확실치 않아요
몇 시까지 하나요?	저녁 12시까지 운영합니다
예, 그러면 지금 겨울이라서 혹시 저희 아직까지 많이 춥잖아예, 그러니까 거기 가게 되면 따로 아이들이 가면 놀 수 있는 뭐 시설이 되어 있나요?	유아 숲 체험원이라는 아이들 놀이 공간이 있는데, 겨울에는 날씨 때문에 산책로만 운영하고 있어요
바비큐 하려면 어떻게 해야 돼요?	미리 신청하시면 저녁에 바비큐장에서 사용 가능하세요
배달음식 주문이 가능한가요?	이 가게는 음식을 드실 수 없습니다
컵라면 주문하고 싶은데 얼마에요?	2000원입니다
네, 몇 명이신가요?	일주일 묵으실 방 있어요
텐트랑 식기구 대여는 얼마인가요?	3인이 이용하실 텐트 대여는 5만 원이며, 식기 구는 4만 원이에요
아무 자리에 가서 하면 되나요?	아뇨 지정석으로 안내해드릴게요
근처 관광코스 문의는 어디에 하면 되나요?	1층 로비에 패키지 관광코스 상담창구가 있어요
포켓볼은 없나요?	전에는 있었는데 지금은 없어요
1박 2일로 예약 해주실래요?	예약 도와드릴게요
그러면 음료수는 뭘 드릴까요?	콜라 2개랑 사이다 4개로 주세요
앱에서 할인쿠폰 다운로드해왔는데 할인되나요?	할인쿠폰 있으시면 10% 할인돼요
토요일이에요?	토요일 맞아요
연박 가능할까요?	일정상 가능한 방은 오션뷰 뿐이에요
음식을 시켜 먹어도 될까요	가능합니다
같이 숙박하시는 분이 원체 깔끔한 성격이라서 매일 침구 교체해주나요?	예약하실 때 말씀해주시면 매일 침구 교체도 가능해요
예약 한 사람인데, 확인 해주실래요?	위쪽 두 번째 텐트 이용하세요
다시 전화 드리겠습니다	전화 주세요
선불 요금이랑 음료수 콜라 결제해주세요	자리로 음료 드리겠습니다
두 개가 이어진 좌석이 있나요?	있습니다
컴퓨터 사양은 베틀그라운드 그런 거는 다 돌아갈 정도 되나요?	최고 사양이나 그런 거는 아니지만 기본적인 건 다 돌아갑니다
언제인지에 따라 달라요. 언제 숙박하실 건가요?	원래 15만원인데 하루는 12만원에 드릴게요. 현금 결제시면 11만원으로 해드릴게요
성함하고 생년월일 알려주실래요?	신분증으로 보여드릴게요
제가 예약한 방 이 몇 호인가요?	15층 1501호예요
후불로 2 명할 자리가 있나요?	당연히 있죠
남은 시간은 저장되나요?	회원으로 로그인하셔서 충전하시고 남은 시간은 저장됩니다
네, 언제부터 언제까지 묵으세요?	마침 비어있으니 그 시간대로 예약받을게요
여기 후불 선불 둘 다 가능한가요?	후불 선불 둘 다 가능하세요
숙박 예약하고 왔는데요	여기 키랑 안내사항 확인해주세요
오늘부터 2일 예약 했는데, 확인해주실래요?	김철수 고객님, 확인 되었어요
흡연실도 따로 있나요?	흡연실은 따로 있습니다
라면은 가격이 어떻게 되나요?	천 원입니다
우리 애가 요 당구를 좋아가지고 대회 나가려고 당구를 배우려면 얼마쯤 하나요?	여기 근처 크로스에스라고 당구장에 가시면 거기는 전문적으로 가르치는 사람이 있어요
주말과 평일 요금이 다른 가요?	달라요. 평일은 4인 기준 10만 원이고, 주말은 4인 기준 13만 원이에요
조식도 예약하시나요?	약 도와드릴게요
두 가족이신가요?	최대 6명에 방이 하나 거실이 하나 침대가 구분되어 있고, 화장실이 두 개라 두 가족이나 커플 둘이 오는 경우 선호하는 방이에요
이용할 수 있는 프로그램이 있나요?	행사 프로그램은 없어요
다 켜져 있는데 안돼요	바꿔드릴게요
객실로 배달음식을 시켜 먹을 수 있나요?	배달음식 가능해요
게임하다가 음식 시키고 싶으면 어떡하면 되나요?	화면상에 보시면 음식 고를 수 있는 창 있으세요
한자리 주세요	30번 자리로 가세요
체크인 시간은 언제?	체크인은 3시부터예요
가격이 어떻게 되나요?	1박에 9만 원이에요
컵라면도 되나요?	물론입니다 자리로 갖다 드릴게요
영업 종료 시간을 알려주세요	새벽 1시입니다
음식같은 거도 주문을 할 수 있나요?	자리에서 주문하셔도 되고 카운터 오셔서 주문하셔도 됩니다
와이파이 같은 거는 다 설치되어 있나요?	와이파이는 다 설치 되어 있습니다
결제는 카드로도 가능한가요?	카드로도 가능하시고 계좌이체도 되세요
외부음식도 주문할 수 있나요?	외부음식은 주문하실 수 없으세요
여기 흡연실도 있나요?	죄송한데 흡연실은 따로 없습니다
여기 피파온라인 가맹점인가요?	피파 가맹점입니다
바비큐 가능 시간은 몇 시인가요?	오후 5시부터 오후 9시까지에요
체크아웃은 몇 시에 해야 하나요?	오전 11시까지 체크아웃하셔야 해요
몇 명이에요?	8명정도 될 거 같아요
네, 몇 인실로 바꾸시겠어요?	4인실로 주세요
냉장고도 있나요?	냉장고 있어요
10시간 충전하면 얼마인가요?	10000원입니다
투숙은 몇 명이 하시나요?	투숙 예정일 알려주시면 예약해드릴게요
이 펜션 소음으로 많이 시끄럽지는 않나요?	소음은 전혀 없어요
근처에 조식 먹을 만한 곳은 있나요?	불국사 쪽으로 나가면 식당 많아요
숙박비 얼마입니까?	객실당 5만 원이에요
예약은 가능한가요?	약도 하시려고 하면 가능하세요
얼마 놓고 치세요?	저 150이요
방은 어디로 가면 되죠?	3층 302호로 가시면 돼요
튀김 가락국수는 얼마에요?	1500원입니다
혹시 생수도 파나요?	1병 서비스로 드릴게요
몇 시간 정도?	기본 3시간이에요
룸서비스 이용 시간은 몇 시까지 가능한가요?	룸서비스는 오전 열 시에서 오후 열 시까지 가능하시지만, 아홉 시 삼십분 전에 마지막 주문을 해주셔야 해요
이번 주말에 4인실 예약이 가능한가요?	이번 주말 4인실 예약 가능하세요
아무 자리나 이용하면 되나요?	카드에 적힌 번호 자리 이용하시면 됩니다
가격은 10분에 얼마정도 나오나요?	1400원이요
바비큐장 이용하시겠습니까?	저녁에 이용하겠습니다
내일 몇 시까지 나가야 하나요?	12시까지 퇴실하시면 돼요
네, 예약하실 날짜를 말씀해 주세요	25일부터 27일까지입니다
초크가 떨어졌는데 초크 있나요?	여기 있습니다
요금은 회원가입을 해야만 사용이 가능한가요?	비회원도 사용 가능합니다
혹시 카드 결제도 가능한가요?	카드 결제도 가능합니다
여기 회원가입은 어떻게 해야 되나요?	피씨에서 로그인 화면에 회원가입 누르시면 됩니다
와이파이는 되나요?	되긴 되는데, 약할 수 있어요
카드 결제도 가능한가요?	컴퓨터로 주문 후 음식을 받으실 때 카드를 주시면 됩니다
당구장 언제까지 하나요?	24시간 합니다
서비스 음료는 뭐가 나오나요?	오렌지주스, 아메리카노, 믹스커피가 준비되어있습니다
어떤 방을 원하시나요?	와이파이 되고 컴퓨터가 있는 방이요
다른 비상구는 어느 쪽에 있나요?	비상구는 저 쪽에 있습니다
바비큐 사용 가능하나요?	바비큐장 구비되어 있어요
야 놀자 쿠폰 사용 가능한가요?	성수기라 쿠폰 사용은 안 돼요
대실 사용시간은 몇 시간인가요?	대실 사용시간은 4시간이에요
컴퓨터 속도 빠른가요?	rtx2080을 장착하여 이보다 빠를 수 없습니다
모텔 안에 에어컨이 있나요?	방 안에 에어컨과 선풍기 둘 다 있어요
혹시 게임 충전도 가능한가요?	컴퓨터 상에서 가능합니다
방 예약하려고 하는데 가능할까요?	3인 시티뷰로 예약 진행하겠습니다
고기 구워 먹기 전에 말씀드리면 불 넣어주시죠?	30분 전에 말씀해주시면 숯불이랑 불판 준비해드려요
2박 예약했는데, 지금 체크인 가능한가요?	청소 중인데, 조금만 더 기다려 주세요
호텔 위치가 어떻게 되나요?	강원도 속초시 속초 경찰서 인근에 있어요
저희 전산상으로 확인이 되지 않는데, 문자 보여주시겠어요?	우선 룸에 먼저 올라가시면 제가 확인 후 다시 연락드릴게요
대 다이로 드릴까요?	아뇨 중 다이면 충분합니다
저희가 이용할 수 있는 바비큐 시설 있나요?	숯불 사용은 안 되세요. 버너랑 불판 가져오시면 마당에서 고기 드시는 건 가능해요
내일 체크아웃은 몇 시인가요?	11시예요
네 무슨 문제가 있나요?	여기 스피커가 안 나오는 것 같아요
건물에 주차할 수 있는 공간은 따로 있어요?	지하주차장 이용하시면 됩니다
15000원에 2시간은 안 되나요?	15000원에 2시간 가능합니다
짜장면 배달 가능할까요?	불러드리겠습니다
당구장 몇 시에 여나요?	오전 11시에 영업 시작합니다
핸드폰 번호 좀 알려주세요	01012345678입니다
근처에 맛집 추천 적혀 있던데?	펜션 들어오는 입구에 순두부집이 유명한데 아침 6시, 7시부터 열어요
체크 아웃 시간은 몇 시인가요?	11시예요
자녀분 나이가 어떻게 되세요?	초등학교 삼학년이에요
예약도 가능한가요?	약은 받지 않고 있어요
포켓볼은 시간당 얼마인가요?	10분에 2000원 받고 있어요
프린트 가능한 자리가 어디죠?	전 PC 가능합니다
계산이 카드로도 가능할까요?	카드로 계산 가능합니다
개인 강습은 한 몇 시간?	하루 정도는 한 서너 시간 해주는 거 같은데요. 그리고 그 다음부터는 계속 혼자 연습 하시는거죠
자주 이용하는 배달음식집 추천해주실 수 있나요?	추천할 만한 식당 전화번호를 알려드릴게요
모닝콜 가능할까요?	몇 시인지 말씀해주시면 모닝콜 해드려요
사구 한 개 주세요	사구는 테이블로 바로 가시면 되세요
2박 3일에 얼마 들죠?	2박 3일 가격은 13만 원이에요
체크인 되나요?	고객님의 예약이 확인됐고 호텔 방은 1032호예요
후불로도 결제가 가능한가요?	선불로만 결제 가능합니다
여기 금연석이 따로 있나요?	저희 pc방은 모든 자리가 금연입니다
그럼 담배는 어디서 피워야 해요?	건물 옥상이나 1층으로 내려가시면 됩니다
계산은 카드로도 가능 한가요?	카드는 따로 안 되시고 현금이랑 계좌이체만 가능합니다
바비큐 파티에 술도 있나요?	술은 따로 없어서 개인적으로 사 오셔야 해요
네, 어떤 방 원하시나요?	패밀리룸이요
호텔과 연계된 렌터카 회사가 있나요?	연계된 렌터카 회사는 없어요
몇 분이 머무르실 건가요?	2명이요
초크도 갖다 주세요	알겠습니다
몇 분이 묵으실 건가요?	패밀리 전용방으로 드릴게요
네, 일회용품 필요하신가요?	필요 없습니다
간식은 어디서 시키나요?	컴퓨터로 주문하시면 되고 주문방법은 기재되어 있습니다
체크인은 언제인가요?	오후 3시예요
예약 날짜는 어떻게 되나요?	1월 1일에 하고 싶어요
혹시 여기 배틀그라운드 다 돌아가나요?	전 좌석 배틀그라운드 다 돌아갑니다
포켓볼 1시간에 얼마인가요?	한 시간에 7000원입니다
방에서 밤에 배달음식 주문해도 되나요?	방에서 배달음식 주문하실 수 있어요
애완견 데리고 가도 되나요?	애완견은 짖기 때문에 항의가 들어와서 출입이 불가능해요
후불제로 이용 가능한가요?	저희 pc방은 선불제입니다
조식은 몇 시인가요?	아침 7시부터 10시까지 가능해요
음료는 따로 주문 가능한가요?	가능합니다
혹시 프린트되나요?	흑백이랑 컬러 둘 다 가능하세요
3구에서 4구로 옮기겠습니다	4구 가셔서 스타트 누르시면 자리 옮겨드리겠습니다
이용료가 어떻게 되나요?	1시간당 만 원입니다
배달 음식 시켜 먹어도 되나요?	배달 시키셔도 되세요
아침 식사가 다 가능한 거죠?	아침 식사 다 가능한 식당이에요
3구대 있어요?	창문 쪽에 있어요
요즘 바비큐도 해 먹나요?	바비큐 불 피워달라 하면 불 피워줘요
몇 시부터 영업하세요?	24시간 당구장입니다
여기 포켓볼도 칠 수 있나요?	포켓볼 대는 2대 있는데 현재 다른 손님이 이용 중이라 기다리셔야 합니다
여기 시간당 얼마인가요?	1인 1시간당 1000원입니다
3월 30일은 2명씩 따로 머물 수 있는 방으로 예약 가능할까요?	명 같이 머물 수 있는 방 가능해요
삼월 십육일 예약 가능한가요?	토요일로 빌라 스위트라고 베드 세 개 있는 육 인실이 있어요. 삼 인실 하나, 이인실 하나 사용도 가능하세요
배달시켜 먹을 수 있나요?	룸까지는 배달이 안 되고 로비에서 가져 가셔야 해요
공항에서 호텔까지 택시 요금이 얼마 정도 나오나요?	택시 요금은 만원 안 나오실 거예요
금요일로 예약되나요?	금요일 2명 예약되었어요
토요일에 2명 예약해주세요	토요일 2명 예약해드릴게요
침대방은 얼마에요?	침대방은 십이만 원이요
휴일도 있나요?	저희는 365일 24시간 운영해요
그럼 음식은 앉아서 주문하면 되는 거죠?	원하는 메뉴 담으시고 주문하시면 됩니다
먹고 내놓으면 되나요?	드시고 뒷정리까지 해주셔야 합니다
몇 분이신가요?	저희 성인 두 명하고 아기 한 명이에요
5월 1일 날 예약 가능한가요?	가능해요
카드로 결제되나요?	음식 주문은 현금만 가능합니다
당구대 교체해주세요	무엇 때문에 그러시죠
두 분 맞으시죠?	맞습니다
숙박은 보통 열두 시 전에 나가는데, 몇 시쯤 오시나요?	한 세 시쯤에 도착할 거 같은데요
음식 주문 가능한가요?	햄버거랑 핫도그 종류 가능합니다
객실 하나 이용하세요?	어떤 게 나을지 좀 여쭤볼까 싶어서요
네, 어떤 자리 원하세요?	안 쪽에 조용한 자리가 남아 있나요?
가스레인지는 어떻게 쓰나요?	방마다 인덕션이 설치되어 있으니 시간을 두고 기다리 신 후 쓰시면 돼요
여기서 얼마나 걸리나요?	그럼 그냥 건물 화장실로 가야 할 것 같아요
여기 인쇄되나요?	가능하세요
룸에서 음식을 시켜 먹을 수 있나요?	배달음식 가능하세요
비상구는 있나요?	비상구는 여기랑 저쪽 보시면 있습니다
숙박 가격이 구만 원이라고 하셨죠?	일박에 구만원이에요
샤워장에 온수 나오나요?	나와요
오늘 처음 왔는데 정액제로 할게요	알겠습니다
방에 침대가 있나요?	더블 침대가 있는 룸이에요
삼성페이나 카카오페이도 되나요?	삼성페이는 되는데 카카오페이는 안 됩니다
이것도 하나 살게요	자리 잡으시고 메시지 보내주시면 갖다 드리겠습니다
포켓볼 다이 있나요?	있습니다
아무 자리에 가서 하면 되나요?	이쪽에 있는 컴퓨터들만 프린터에 연결돼있습니다
식사 주문은 어떻게 하죠?	좌석에 있는 주문 버튼을 눌러주세요
여기 한 시간에 얼마에요?	한 시간에 1000원입니다
흡연석 있나요?	없습니다
체크인 좀 하려고 하는데, 되나요?	체크인은 10시부터예요
수영장이나 골프장은 없나요?	수영장, 골프장은 없어요
네, 김철수 님 세분 예약하신 거 맞으세요?	맞아요
해당 부서 번호 어떻게 돼요?	일오팔팔 둘둘구구 번이고 영 번 누르면 바로 상담원 연결돼요
취사도구는 당연히 되어있고요?	취사도구는 다 준비되어 있어요
2명이 묵을 방 있나요?	딱 하나 있어요
여기 화장실 어디있어요?	화장실 저기 끝에 있습니다
방은 따뜻한가요?	방은 오시기 전에 따뜻하게 만들어 놓아요
투숙객 관광지 할인 티켓이 있나요?	관광 안내센터 가시면 받으실 수 있어요
바비큐 이용할 수 있나요?	,바비큐는 추가 비용 2만 원이에요
텐트 대여는 얼마인가요?	60000원이에요
필요하신 날짜가 언제인가요?	4월 13일 주말 1박 2일로 이용하려고 하는데
포켓볼을 치고 싶은데 기다려야 하나요?	30분 정도 기다리셔야 합니다
몇 분이세요?	3층에 있는 방으로 드릴게요
공항까지 버스로는 얼마나 걸려요?	버스로는 한 사오십분 걸리고 일반 승용차로는 십오분에서 이십 분 정도 걸려요
상의를 좀 해보고 전화를 드릴게요	인스타그램 하시면 저희 방 보실 수가 있고 홈페이지도 한 번 둘러보세요
그럼 3명씩 앉을 수 있게 자리 좀 잡아주세요	약은 따로 받지 않고 있습니다
캠프파이어 서비스도 추가하실 건 가요?	고기는 사 가야 되죠?
바비큐 1인당 이용료는 얼마인가요?	1인당 만 오천 원이에요
그럼 프린트는 1장당 얼마인가요?	컬러는 500원 흑백은 100원입니다
몇 시까지 대실 가능해요?	9시까지 가능하세요
언제까지 준비해드릴까요?	6시까지 준비해주세요
아침식사는 제공되나요?	아침식사는 제공되지 않아요
아침은 주나요?	저희는 조식 제공을 안 해요
바비큐는 몇 시부터 해주실 수 있나요?	5시 이후 아무 때나 가능해요
그럼 1시간 충전하면 1시간 더 추가되는 건가요?	그렇습니다
한 시간에 얼마에요?	50분에 1000원이요
3월 중순경에 펜션 예약할까 해서 전화 드렸는데?	3월 중순에 예약 가능해요
방에 와이파이 잡을 수 있나요?	각 방에 와이파이 비번이 적혀있어요
봉사료는 저희가 드려야 되나요?	아니요, 봉사료는 따로 없어요
청소년은 혹시 몇 시 까지 사용이 가능한가요?	청소년 손님은 잘 없어서요
사월 육일이요?	사월 육일 일박 이일이요
사우나도 있어요?	사우나도 있어요
바비큐 준비는 미리 부탁드려야 하나요?	한 시간 전에 말씀해주시면 돼요
그럼 포켓볼로 준비해주시겠어요?	창가 쪽 다이 이용하시면 됩니다
체크인하려고요	더블 싱글룸으로 예약하신 걸로 확인되세요
회원가입을 해야만 이용이 가능한가요?	회원가입을 하지 않아도 이용 가능합니다
저 혹시 흡연이 가능한 자리가 있나요?	저희 PC방은 어린 학생들도 오는 곳이라 금연입니다
몇 분이세요?	총 사인이거든요
예약자 성함이 어떻게 되시죠?	홍길동으로 예약했습니다
컴퓨터 사양은 요새 배틀그라운드 이런 게임 다 가능한가요?	배틀그라운드 같은 게임 모두 렉 없이 돌아갑니다
제일 작은방은 없나요?	좀 많이 작을 텐데 괜찮으시겠어요?
조식 추가 가능한가요?	결제는 체크아웃 때 해주시면 돼요
혹시 당구 칠 줄 아세요?	칠 수는 있는데 잘은 못 칩니다
그 정액제는 얼마인가요?	정액제는 회원만 하실 수 있고 10시간에 9000원입니다
한 시간에 얼마에요?	천 원이요
예약하셨나요?	예약번호 1234입니다
혹시 계산은 카드도 가능한가요?	카드로 계산 가능합니다
3개월 무이자 할부로 결제되나요?	카드사마다 상이하며 홈페이지에 카드사별로 결제 혜택이 상세하게 나와있어요
화장실은 어디에 있어요?	화장실은 바깥으로 나가셔서 바로 옆에 있습니다
주위에 관광지는 있나요?	펜션 주위에 문무대왕릉하고 주상절리 있어요
퇴실은 몇 시인가요?	오전 10시에서 11시 사이에 하시면 돼요
혹시 일행한테 사구 가르쳐주실 수 있는 분 계실까요?	지금 사장님이 안 계셔서 어려울 것 같습니다
공항까지는 셔틀버스가 운행되고 있나요?	공항 셔틀버스는 없는데, 택시는 저희가 불러드릴 수 있어요
예약 입금 안내 부탁드립니다	입금 확인되면 확인 문자 드리겠습니다
당구 채 하나만 더 주시겠어요?	대여비 1000원입니다
네, 고객님 성함이 어떻게 되시나요?	김철수입니다
풀장이 있나요?	공동 풀장은 있어요
칫솔은 방에 있나요?	두 개 있어요
경주는 와 보셨어요?	경주는 예전에 와봐서 잘 몰라요
생수 좀 더 주실래요?	생수 더 준비해드릴게요
몇 분이신가요?	두 명인데, 1명씩 해서 방 2개를 예약하려구요
장갑 대여도 해주나요?	장갑 준비되어있습니다
와이파이 있나요?	있습니다
포켓볼 요금은 어떻게 되나요?	한 시간에 6천 원입니다
방 있나요?	방 있어요
2만5천원 2인 기준이면 6명이면 얼마죠?	바비큐는 6인 하시면 2만5천원짜리 하시면 돼요
큐대는 어디 있는 것을 쓰면 되나요?	왼쪽 벽에 걸려있는 것을 쓰면 됩니다
몇 분이세요?	혼자에요
수영장은 있나요?	수영장은 없어요
바다전망으로 하고 싶은데요?	바다 전망 2인 기준 15만원이에요
홍길동으로 예약했습니다	확인해드릴게요
9시에 몇 분이세요?	예약명단에 올려드릴게요
2인실에 침대 하나를 더 놓으면 조금 좁더라도 연속으로 한 방을 쓰실 수 있는데, 그렇게 해드릴까요?	2인실에 한 명 추가하면 가격도 조금 쌀 테니 그렇게 해주세요
네, 체크아웃은 월요일 열두 시인데 예약을 잡아놓을까요?	제가 몇 군데 앱으로 요금 보고 전화드리고 있거든요
몇 박 예정이세요?	1박만 할 거에요
방은 몇 시까지 비우면 되나요?	오전 11시까지 방을 비우셔야 해요
요금은 회원이랑 비회원이랑 다른가요?	비회원이 100원 더 비쌉니다
따로 음식 만드는 코너가 있나요?	저희는 주방에서 식사할 수 있게 다 준비되어 있어요
요금 좀 알려주세요	기본요금 오천 원에 10분에 1500원 추가 요금 있습니다
당구대가 괜찮네요	과찬의 말씀입니다
비상구는 다 마련되어 있나요?	비상구 마련 다 되어 있습니다
숙박은 얼마인가요?	숙박은 5만 원이에요
네 혹시 첫 방문이신가요?	결제는 선불이고 후에 시간 추가 가능합니다
그러면 현금으로 결제하겠습니다	40000원입니다
객실 이용하다가 필요한 게 생기면 어떻게 해야 하나요?	객실 내부에 비치되어 있는 전화를 이용하셔서 말씀해 주세요
계좌 이체해도 되나요?	그건 가능해요
비상구는 어느 쪽에 있을까요?	뒤에 흡연실에 비상구가 있습니다
그럼 혹시 주차할 수 있는 공간은 있을까요?	주차 공간은 없습니다
외부음식도 시켜 먹을 수 있나요?	근처 식당이 많아 시켜 드실 수 있으세요
다른 거는 돈 들어가는 건 특별히 없어요?	특별히 비용 들어가는 건 없어요
오션뷰 십육만 원이면 조식 포함 금액인가요?	오션뷰도 조식 불포함 금액이에요. 패키지로 시내 전망은 조식 포함이 십칠만 원, 오션뷰는 십칠만 사천 원이에요
카라반 이용 시 바비큐 이용 가능합니까?	바비큐 이용 시 금액에 이용 가능하십니다
3명이 나란히 붙어있는 자리가 있나요?	안내해 드리겠습니다
숙박비는 얼마인가요?	1박에 4만 원이에요
일단 자리에서 회원가입을 해주세요	회원가입하셨으면 저쪽 기계에 돈을 넣으시면 됩니다
프린트를 할 수 있나요?	프린트는 40번 자리에서만 가능합니다
날짜는 언제로 해드릴까요?	변경사항 있으시면 3일 전에 미리 전화 주세요
네 어떤 걸로 드시겠어요?	사천 원입니다
혹시 포켓볼 테이블도 있나요?	있습니다
몇 명이서 오시는데요?	3명이 오시면 2명은 침대에서 주무시고 한 명은 이불깔고 주무셔야 해요
퇴실은 몇 시인가요?	퇴실시간은 낮 12시에요
주차할 수 있는 공간은 따로 있나요?	주차 할 수 있는 공간이 있긴 있습니다
한 게임에 얼마나 하나요	5000원입니다
피씨방 자리에서 음식같은 거도 주문이 되나요?	자리에서 음식 주문하셔도 됩니다
결제는 언제 하나요?	체크아웃할 때 하시면 돼요
몇 층인가요?	묵으실 방은 7층에 있어요
카드 결제도 가능한가요?	현금결제만 가능합니다
혹시 프린트도 가능한가요?	감사합니다
계좌이체해드리면 안 되나요?	여기로 이체해주세요
당구장 영업시간이 몇시까지에요?	정해진 시간은 없어요
디럭스 트윈은 얼마에요?	디럭스 트윈은 팔만 원에 이용 가능하세요
호텔에 남는 2인용 객실 있나요?	현재 특실만 남아있어요
오늘 밤 숙박 가능한가요?	오늘 숙박은 어렵고 대실로 4시간 정도 사용하실 수 있는 방만 있어요
무인기계에서 확인해보시겠어요?	그럼 제가 확인해드리겠습니다
현금영수증 발급 가능한가요?	가능합니다
음료수나 다른 마실 거리가 있나요?	오른쪽 편 냉장고에서 꺼내가시면 됩니다
도보로 온천 이용하는 거예요?	주차장 바로 앞에 있어요
지금 짐 맡기고 이따 다시 와도 되나요?	짐 찾으실 때는 번호 키를 보여주시면 돼요
4인 가족이 펜션 이용하려고 하는데 요금이 얼마 정도 되나요?	20만원 정도 해요
숙박 문의 좀 하려고요?	죄송합니다, 아까 전화하셨는데 제가 오늘 애 입학식 갔다가 전화를 못 받았어요
그럼 그냥 현금으로 할게요	결제되셨습니다
뷔페식 나오고 조식까지 포함하면 얼마쯤 되죠?	6분 숙박에 조식 포함하면 22만6천원이에요
6인이 숙박하려면 어느 방 써야 할까요?	그럼 매화실로 해 드릴게요
제휴 할인되는 카드 있나요?	해당 금액에서는 중복 할인은 안 돼요
대실이신가요, 숙박이신가요?	숙박을 하려고 합니다
저희 호텔이 3인실은 없고 4인실이 있는데, 말씀하신 시간대에는 방이 없는데 괜찮으세요?	중간에 방을 옮겨도 괜찮습니다
흡연실은 어디 있습니까?	흡연실은 저쪽에 있습니다
4구 가능한가요?	4구 지금 바로 치실 수 있으세요
결제는 어떻게 해드릴까요?	카드 결제입니다
감사합니다, 제가 가족하고 의논해보고 전화 다시 드릴게요	전화 주세요
온돌방도 있나요?	온돌방으로 예약해드릴까요?
비회원으로 2시간 선불하고 싶은데 어디로 가면 되나요?	마침 자리가 남아있어서 3번 자리에 번호표 입력하고 시작하시면 됩니다
이번 주 금요일, 토요일, 일요일 2박 3일  캠핑 예약 가능한가요?	주차 자리도 마련해 놓을게요
조금만 더 상의해보고 다시 전화드리도록 하겠습니다	전화 주세요
수강료는 한 얼마쯤 하는가 그래서요?	돈은 전체적으로 서울이나 대구나 다 다르고, 선수 반은 매일 와야 하는 거거든요
조식 추가하면 얼마에요?	한 끼당 8000원이에요
여기 카드요	3만 원 결제 도와드릴게요
풀빌라면 다른 방보다 돈이 많이 올라가겠네요?	수영장이 많이 크고 따뜻한 물로 다 준비를 해드리고 있어요
와이파이 같은 건 다 설치되어 있나요?	와이파이 다 설치되어 있습니다
어떤 맥주로 드릴까요?	얼음 따로 챙겨주세요
회원가격은 얼마인가요?	회원가입 시 가격 할인되어 1000원에 이용 가능합니다
예약 확인 해주실래요?	2008호예요
비상구는 어느 쪽에 있어요?	출입구 오른쪽으로 가면 바로 보이실거에요
인원이 몇 분이세요?	총 네 명이에요
혹시 외부음식은 시켜먹을 수 있나요?	근처 식당이 많아서 시켜드시면 되세요
공휴일에도 다 영업하시나요?	365일 휴일 없이 영업해요
그럼 청소년들은 몇 시까지 이용 가능한가요?	청소년들은 아침 9시부터 저녁 10시까지 이용 가능하세요
커피숍 이용 시간이 어떻게 돼요?	커피숍은 일곱시 반부터 저녁 아홉시까지예요
커플석 혹시 있나요?	커플석은 없습니다
네. 이불을 추가로 얼마나 준비해 드릴까요?	두세 장 정도요. 수건도 몇 장 더 주세요
아이스티는 얼마인가요	1500원입니다
더블베드 룸으로 예약되나요?	약 현황 확인해볼게요
커피포트는 있나요?	말씀하시면 가져다드릴게요
여기 금연인가요?	당구장은 금연구역으로 지정되었습니다
오늘 객실 있을까요?	청소 중인 방이 있는데 잠시만 기다리시면 드릴 수 있어요
여기 카드 결제되죠?	카드 결제 다 됩니다
평일이라 객실 할인은 되고, 타입은 어떤 거로 원하시나요?	저희가 성인 두 명하고 아기 한 명하고 세 명이 묵으려고 하는데요
1층과 2층이 있는데 몇 층이 좋으세요?	아이들이 있어서 1층으로 할게요
영수증은 필요 없어요	영수증 버려드릴게요
삼구랑 사구 말고 다른 거는 없나요?	충분하다고 생각해서 들여놓지 않았어요
오월은 가정의 달이라서 가격이 조금 더 비싼가 보네요?	오월은 손님이 많아서 가격이 좀 올라요
스탠더드 더블룸 맞으십니까?	될 수 있으면 높은 층으로 부탁드려요
오늘 사람이 많은데 음식도 오래 걸릴까요?	오늘은 마찬가지로 10분 정도 걸릴 거 같아 앉아서 미리 주문하시는 게 나아요
카드 결제 되나요?	카드 결제 가능해요
네 햄버거 콜라 카드로 결제 좀 해주세요	2500원입니다
최대 인원이 넘으면 어떡하나요?	죄송하지만, 표기된 최대 인원이 넘으면 사용이 불가해요
체크아웃은 언제까지 해야 하나요?	다음날 낮 12시까지에요
4인 초과 시 추가 비용이 발생하나요?	추가 비용은 없습니다
몇 분이신가요?	어른 2명이 갈 거예요
요금은 10분에 얼마정도 해요?	10분에 1300원하고 1500원 있어요
1000원 맞지요?	맞습니다
몇 분이세요?	두 명이고 하루 묵을 거예요
장갑도 주세요	알겠습니다
네, 성함이 어떻게 되시죠?	김철수입니다
방 하나 주시고, 얼마죠?	하루 숙박이시면 6만 원이에요
그럼 청소년들은 몇 시까지 이용할 수 있나요?	청소년들은 오전 9시부터 저녁 10시까지 이용 가능합니다
바비큐 하실 건가요?	그것도 같이 신청했습니다
4명인데 어디로 가면 되나요?	저기 세 번째로 가서 치세요
테이블 주세요	5번 테이블로 가세요
게임 종목은 삼구만 있나요?	사구도 준비되어 있어요
그럼 여기 베그도 가맹점인가요?	그렇습니다
후불로 할게요	카드 가져가세요
금연방으로 드릴까요?	엘리베이터를 타고 3층으로 가시면 돼요
현금 9만 원 결제해 주세요	현금 9만원 결제 해드릴게요
한 달 정도 하면은 가격이 어예 되나요? 혼자 있는데?	120만원 정도 돼요
온돌방은 있나요?	온돌은 없어요
혹시 당구장 안에서 음식 배달 시켜 먹어도 되나요?	가능합니다
배그 돌아가나요?	환상적인 그래픽을 저희 pc방에서 느껴보세요
네, 숙박 원하세요?	오늘 하루 숙박이요
그럼 짜파게티 하나 갖다 주세요	3000원입니다
여기 회원가입 어디서 해야돼요?	자리에서 회원가입 하시면 돼요
결제는 카드로 되나요?	죄송하지만 현금 결제만 가능해요
네 테이블 2대 있는데 몇 분이세요?	4명인데요 테이블 하나면 돼요
계산은 혹시 카드로도 가능한가요?	카드로도 계산 가능하세요
한 게임 당 얼마인가요?	옆 동네는 1500원이던데, 여기는 좀 비싸네요
더블베드 룸도 있나요?	싱글사이즈 더블베드 룸 있어요
예약자분 이름이 어떻게 되시나요?	KIM이에요
와이파이는 혹시 설치되어있나요?	와이파이 설치되어 있습니다
여기 포켓볼 자리 있나요?	저기 안쪽으로 들어가면 있어요
일주일 전에 호텔 앱으로 분명히 결제했는데, 왜 확인이 안되나요?	예약 확인되었어요
취사도구는 다 있죠?	취사도구 다 구비되어 있어요
끝날 때 다 돼가는 자리 없어요?	한 시간은 기다리셔야 됩니다
PC 사용료는 어떻게 돼요?	30분당 1500원입니다
비회원이시죠?	맞아요
예약은 가능하시고 몇 분 정도 투숙하세요?	성인 두 명이거든요
방 있나요?	특실로 결제 도와드릴게요
그러면 포켓볼 다이 있나요?	포켓볼은 5분 정도 기다리셔야 할거 같아요
여기 혹시 현금 결제 밖에 안돼요?	카드 결제도 됩니다
저희 담당 부서 한 번 연결해볼게요. 조금만 기다려 주시겠어요?	기다릴게요
공휴일에도 영업하시나요?	휴일없이 일 하고 있어요
바비큐 가격은 얼마에요?	2만 원이에요
삼성페이도 가능하죠?	기계가 구형이라 삼성페이는 불가능하세요
호텔에 편의시설은 어떤 게 있나요?	조식 중식 석식을 드실 수 있는 레스토랑도 있고, 스파 이용도 가능하고 편의점도 있어요
결제는 현금으로 할게요	현금 결제 도와드릴게요
흡연실은 어디에요?	흡연실은 왼쪽으로 가시면 있어요
2인실인가요?	2인실입니다
몇 분이신가요?	어른 둘 아이 둘입니다
혹시 카드 결제도 가능한가요?	카드 결제 가능합니다
3시간에 얼마인가요?	3000원입니다
연방을 하면 할인이 가능한가요?	2박 이상 시에 1박마다 10퍼센트의 할인이 들어가요
수요일에 세 명 예약 부탁드려도 되나요?	예약해드렸고 체크인은 11시부터 가능해요
하루 숙박에 얼마나 하나요?	숙박비는 1박에 8만 원이에요
인당 추가요금은 얼마인가요?	5만 원이에요
중국집 전화번호 좀 주시겠어요?	짜장 당구대에 흘리지 말아 주세요
오늘 저녁에 여기 친구들이랑 단체로 올껀데 자리 예약돼요?	자리 예약하기가 좀 난감해서 자리 예약 안해도 돼요
당구대 새 거 없나요?	여기 있습니다
여성전용 당구대가 있나요	안쪽으로 보시면 칸이 나누어져 있습니다
카카오페이 가능한가요?	카카오페이는 안 되고 예약하시려면 현금 입금하셔야 해요
몇 시에 입실 가능한가요?	오후 3시부터 가능해요
헤드셋 대여도 가능한가요?	가능합니다
바비큐실 이용대금 있나요?	2만 원 발생돼요
인쇄를 하고 싶은데 어디로 앉아야 하나요?	원하시는 좌석에 앉으신 후 인쇄 설정에서 프린트 1로 연결하시면 됩니다
방은 몇 호인 가요?	방은 1102호예요
다섯 명 예약하려고 하는데 가격이 어떻게 될까요?	4인실 10만 원에 1인 추가 15000원 하셔서 총 11만 5천 원이에요
바비큐장 따로 있나요?	바비큐장이 1층은 공용이고 2층은 개별이에요
여기 3구로 부탁드릴게요	3구로 가져다드릴게요
와이파이 같은건 있어요?	와이파이 다 돼요
6시간 대실하면 좀 깎아주나요?	6시간은 대실하시면 할인해서 5만 원만 받을게요
룸 안에 냉장고나 드라이기 있는지 알 수 있을까요?	냉장고와 드라이기 모두 있어요
네, 몇 분이세요?	4인 방이 있나요?
바비큐장 이용할 수 있는 시설이 있나요?	바비큐장은 방 앞에 개별적으로 테라스가 있고 숯은 따로 피워 드려요. 가격은 만 오천원 정도 받고 있어요
바비큐장 이용 비용은 별도인가요?	이용비는 없고 숯만 유료로 구입하실 수 있어요
오늘 캠핑 예약 확인 해주실래요?	여기 동의서 사인해 주시고 쓰레기는 이 봉투에 담아서 버려주시면 돼요
음료는 뭐 뭐 있어요	저기 메뉴 보고 골라 주시면 됩니다
가족이 묵을 수 있는 독채 있을까요?	독채가 하나 있어요
여기 콜라 다 떨어졌는데 리필 가능할까요?	아 지금 슈퍼에 가서 사 올게요
사장님 마실 건 어떤 거 있나요?	커피랑 탄산음료 있어요
결제는 뭘로 하시겠어요?	현금으로 할게요
붙어있는 자리를 원하시나요?	붙은 자리로 주세요
삼양라면 없어요?	저희 가게에서는 삼양 제품을 쓰지 않습니다
쓰레기 봉투가 모자라면 어떻게 하나요?	사무소에 오시면 추가로 금액을 내고 구매하실 수 있어요
가격은 어떻게 되나요?	특실이 7만 원이고 일반실이 5만 원이에요
배달음식도 가능한가요?	다른 손님들도 다 시켜 드십니다
두 분이시죠?	두 명이요
아니요 어떤 걸로 하시겠어요?	음료 여기 있습니다 시작 버튼 누르시고 게임 끝나면 다시 눌러주세요
아이스커피 2개랑 참깨 라면 갖다 주세요	8300원입니다
컵라면 주문 가능한가요?	PC 메뉴판에서 주문 가능합니다
몇 분 투숙하세요?	한 명이고 일박 요금이 궁금한데요
어떤 음료가 있죠?	매실차랑 탄산음료 있어요
주차할 곳은 있나요?	건물 뒤쪽 보시면 주차할 곳 있습니다
객실 올라가는 엘리베이터는 어느 쪽에 있나요?	로비 우측으로 가시면 돼요
이따가 저녁에 올 건데 예약되나요?	저녁 6시 이후에 오세요
흡연실은 어느 쪽에 있어요?	흡연실은 안에 있습니다
여기 모텔 대실 얼마에요?	대실은 3만 원이에요
둘 다 4구로 준비할까요?	하나는 포켓볼 칠게요
취미로 치고 있는데 수강료가 얼마쯤 하죠?	수강료는 따로 없고 당구장 비용만 지불하고 오셔서 연습하면 됩니다
요금은 10분에 얼마정도 합니까?	1300원에서 1500원이에요
체크인하려고 하는데요	여권 보여 주세요
스위트룸은 침대가 3개인 방이 있나요?	스위트룸도 침대가 2개까지 밖에 없고 엑스트라 베드를 넣으셔야 해요
방은 따뜻해요?	온돌이 잘 들어와요
자리 예약해 놓을 수 있어요?	저희가 자리 76에서 78번 예약해 놓을게요
몇 분 투숙하세요?	원래는 십이만 원인데 할인해서 일박에 구만 원이니까, 총금액이 이십칠만 원이에요
체크인 시간은 몇 시이고 체크아웃 시간은 몇 시인가요?	체크인은 두시부터 가능하시고 체크아웃 시간은 다음 날 열두시까지 가능하세요
청소년들은 몇 시까지 사용이 가능한가요?	청소년은 10시까지 사용 가능합니다
바비큐 설치해주세요	10분 뒤에 고객님 자리로 갈게요
중국집에서 배달시켜먹어도 되죠?	저쪽에 테이블 있어요
금,토요일은 가격이 달라지나요?	토요일은 9만원이고, 금요일은 8만원이에요
카드로 결제는 안 되나요?	카드로 결제하시면 쿠폰은 쓰실 수 없어요
몇 박 예정이세요?	더블룸으로 안내해 드릴게요
영수증은 필요 없어요	버릴게요
대실 가능한가요?	대실 가능하세요
짜장면 배달시키는 건 가능한가요?	저희 당구장에서는 음식 섭취가 어렵습니다
신라면이랑 진라면 있는데 어떤 걸로 드릴까요?	금방 가져다드릴게요
주차 할 곳은 있어요?	주차장은 당구장 맞은편에 있습니다
유아도 인원에 포함되나요?	유아의 경우에는 3살 이하일 경우 인원수에 포함하지 않아요
일단 자리를 다른 데로 옮겨드릴까요?	그렇게 해주세요
카드 가능한가요?	카드 결제 가능하세요
계산은 카드로도 가능한가요?	카드로도 계산 가능합니다
월풀 욕조가 있는 객실로 부탁합니다	월풀 욕조가 있는 객실은 현재 마감되었어요
적립 카드 있나요?	적립 카드는 없어요
여기 처음 왔는데 어떻게 이용해야 되나요?	우측에 보이는 키오스크로 선불결제 후 사용하시면 됩니다
방에 요리 도구들이 다 들어 있나요?	부엌 선반에 보시면 이것저것 있으므로 그거 쓰시면 돼요
포켓볼도 가격이 같나요?	저희는 모든 게임이 5000원입니다
다른 방법이 없나요	커플석 좌석이 생기면 옮겨드릴게요
장기는 가능한가요?	가능해요
몇 장 필요하세요?	2장 더 주셨으면 좋겠어요
프린트하려면 어떻게 해야 하나요?	자리에서 인쇄 누르시고 카운터에서 인쇄물 받아 가시면 됩니다
며칠 연박 예정이신가요?	오늘부터 3박 4일 예정입니다
4월 주말에 예약이 가능한가요?	4월 주말, 예약 가능하세요
오늘 하루에 얼마예요?	일박에 10만 원이에요
무료로 주시는 음료 같은 게 있나요?	물을 무료로 드려요
헤드폰 쓰시나요?	스피커에서 안 나와요
키오스크에서 회원가입만 하면 되나요?	로그인하시면 자동 후불로 됩니다
차 여기 세워놔도 괜찮죠?	차 주차하셔도 상관없어요
조금 있다가 예약해도 되죠?	그럼 예약할때 말해 주세요
화장실은 어디 있나요?	밖으로 나가서 한층 내려가시면 됩니다
카드 결제되나요?	카드 결제 돼요
편의시설은 어떤 게 있나요?	매점이 있고 수영장, 탁구장, 놀이방 시설 조그마한 거 있어요
수영장 있나요?	수영장 구비되어 있어요
성함과 생년월일 알려주세요	홍길동 80년생입니다
몇 분이시죠?	2명입니다
고기나 이런 건 다 구비해가야 하죠?	바비큐 재료는 가지고 오셔야 해요
애들하고 같이 자니까 불안한데, 안전 대비 시설 이런 것도 잘 되어 있어요?	비상시 안전하게 대피하실 수 있어요
바비큐 2인 포함해서 캠핑장 1박 숙박 총 요금은 얼마인가요?	총 7만 원이에요
수영장 이용할 수 있나요?	수영장 여름에만 하고 지금은 안 해요
흡연 가능한가요?	저희가 흡연실이 따로 마련되어 있으니까 거기 이용해주세요
네, 성함과 전화번호 말씀해주시겠어요?	김문숙이고 01045654654입니다
주중에는 예약 가능할까요?	오일은 객실이 많이 없고, 사월 일일부터 사월 사일 사이는 아직 여유 있는 상태예요
조식 2명으로 신청해주세요	오전 10시까지 이용 가능해요
요금은 어떻게 되나요?	30분에 1500원입니다
오늘 숙박 가능한가요?	예약 하지 않아도 이용 가능하세요
주차하는 곳도 있나요?	당구장 손님들은 주차하실 수 있는 곳이 있어요
주말에 예약이 가능한가요?	4월 6일에 침실 2개 자리가 있는데, 6명 추가 요금 해서 18만원이에요
여기 요금계산 카드도 되나요?	기계로 하시면 됩니다
상의해보고 전화드리도록 하겠습니다	전화주세요, 감사해요
비회원은 얼마에요?	비회원은 1000원에 한 시간입니다
3시간 사용할게요	3000원입니다
화장실은 어디로 가야 하나요?	나가서 왼쪽으로 가시면 됩니다
와이파이는 다 설치 되어 있나요?	설치는 되어 있는데 아직 사용은 안되세요
시간이 초과되면 PC가 바로 꺼지나요?	1시간 5분 전 팝업창이 뜰 거예요
여기 4구 한자리 주세요	저쪽 3번 당구대 이용해 주세요
혹시 방에서 식사를 해도 괜찮나요?	조리하시는 것만 아니면 드시는 건 가능해요
룸서비스가 가능한가요?	룸서비스는 없어요
혹시 음식 주문도 가능한가요?	음식 주문도 가능합니다
혹시 콜라나 음료 주실 수 있나요?	여기 무한 리필로 드시면 됩니다
가평역에 도착했는데 픽업 가능한가요?	픽업 가능해요
수영장 이용 가능한가요?	4월엔 수영장을 운영하지 않아요
방이 1층과 2층에 있는데 어느 층 방으로 드릴까요?	2층에 있는 방으로 드릴게요
방을 두 개를 잡으려면 삼십만 원이네요?	객실 두 개에 삼십만원이에요
한 게임당 얼마죠?	5000원이요
몇 시에 체크아웃인가요?	오후 12시까지는 체크아웃하셔야 해요
8번 컴퓨터 라면 하나 주세요	10분 정도 소요될 예정입니다
컴퓨터를 다 사용하고 계산은 어떻게 하면 되나요?	컴퓨터는 자동으로 체크되고 프린트는 프린트에 사용된 종이로 계산됩니다
몇 명이서 오시는데요?	3명정도 혹시
침대방 말고 온돌방도 있나요?	온돌방도 있어요
방마다 다른데, 4인이면 아이가 있나요?	아이는 없어요. 몸이 편찮으신 80 되신 어머님이 계셔서 이동하기가 편한 곳이면 좋겠는데
현금으로만 계산 가능한거에요?	현금으로만 결제 하실 수 있으세요
지금 방 있나요?	있어요
라면 음료수 준비 바로 되나요?	준비해 드려요
비상구도 따로 있나요?	비상구도 따로 있습니다
4명이 묵으려고 하거든요, 가능한가요?	레지던스로 가면 되고, 4인 기준으로 7만원이에요
그럼 당구 1팀, 포켓볼 1팀 할게요	여기 3번, 5번입니다
네  혹시 같이 칠 사람 있을까요?	잠시만 기다리세요
뷰가 좋은 룸으로 사인 기준하면 얼마인가요?	싱글베드 네 개가 있는 쿼드 룸이 가능하시고 더블베드 두 개가 있는 더블 디럭스 트윈도 가능하세요
로열룸로 5일 머무르는 걸로 하고 조식은 포함인가요?	조식은 불포함이고, 조식은 1인당 1만 원이에요
삼월 이십삼일, 날짜 맞으신가요?	삼월 이십삼일이에요
사람이 많네요 자리 있나요?	한자리 있습니다
텐트 빌릴 수 있나요?	가능해요
아침 식사도 필요하신가요?	조식도 같이요
아이들이 있어서 조용한 곳으로 해 주실 수 있나요?	조용한 방으로 드릴게요
우리 애가 당구를 배우고 싶다고 하던데 돈이 한 얼마쯤 들어가요?	다른 분들 하시는 거 보니까 오십만원 정도 하는 거 같던데요
포켓볼도 칠 수 있나요?	가능합니다
자리도 제가 원하는 곳 선택할 수 있는 거예요?	맞습니다
네, 있습니다 몇 분이세요?	2명이요
언제 오시는데요?	오월쯤이요
같은 층이 아닌데 괜찮으세요?	방을 2층과 3층으로 드릴게요
평일은 디시를 해드리고 있는데 몇 분이 이용하세요?	저희 총 오인이 묵으려고 하거든요
혹시 포켓볼 당구대도 있나요?	저희 가게에는 포켓볼 당구대는 없어요
그럼 20시간 정액제 먼저 결제하겠습니다	회원 아이디 말씀해주시면 결제 후 정액제 처리해드리겠습니다
1박 2일 하려면 요금은 얼마나 지불해야 하나요?	4분이면 작은 방에 인원 추가해서 15만9천원이에요
이 방 말고 다른 방 주시면 안 돼요?	다른 방은 지금 청소 중이에요
언제쯤 가격이 나오나요?	보통 한 달 전쯤에 가격을 홈페이지에 올리는데 그거 보시고 예약을 하시면 돼요
자차 안 가져가면 연계된 렌터카 회사가 있나요?	연계된 렌터카는 없어서 대구에서 직접 렌트를 해서 오셔야 해요
아까 그 말씀 주신 룸은 전망이 괜찮은 방인가요?	저희가 전 객실이 오션 뷰가 아니지만 아까 말씀드린 디럭스 트윈 같은 경우에는 바닷가 쪽에 있기에 뷰는 괜찮아요
몇 인분 예약해드릴까요?	고기는 8인분으로 예약해주세요
여기 근처에 마트 있나요?	차 타고 5분 정도 가면 있어요
네  몇 시간 이용하세요?	잘 모르겠어요 일단 한 시간 해주세요
회원가입을 해야지만 이용이 가능 한가요?	비회원으로도 이용 가능합니다
침대방인가요? 온돌방인가요?	침대인데 온돌 바닥으로 되어 있어요
체크인은 몇 시인가요?	체크인은 오후 세 시부터 가능하세요
노래방은 인원수는 관계없이?	노래방 룸으로 계산해요
주말에는 얼마해요?	토요일은 삼만원이고 금요일은 이만 오천원이에요
회원가입을 어디서 해야하나요?	회원가입은 피씨 켜시고 하시면 됩니다
마세 해도 되나요?	300이하 금지입니다
뷰가 조금 좋은 방으로 해서 이용 요금이 어떻게 되나요?	디럭스 트윈 하시면 칠만 원이에요
4만원은 침실방 인가요?	침실방이에요
체크아웃 시간은요?	체크아웃은 다음 날 11시에요
와이파이는 다 설치되어 있나요?	와이파이는 다 설치되어 있습니다
평일이라 객실 할인은 되고, 타입은 어떤 거로 원하시나요?	삼인 가족은 패밀리 트윈이라고 해서 싱글 침대 하나가 떨어져 있고, 싱글 침대 두 개가 붙어있는 방이 있어요
결제는 카드 가능한가요?	방 열쇠드릴게요
현금이 없어서 그런데 혹시 카드도 되나요?	이쪽 카드 투입구에 신용카드를 넣어주세요
커플석은 혹시 있나요?	커플석은 따로 없습니다
음료는 어떤 거 드릴까요?	따뜻한 녹차 하나랑 사이다 하나 주세요
회원비는 따로 없나요?	회원비는 따로 없고 미성년자분의 경우 부모님 동의가 필요합니다
오늘 체크인 시간이 어떻게 되죠?	체크인은 오후 4시부터에요
수리가 오래 걸려서 그러시나요?	현재 수리기사가 방문이 불가능해요
저 체크인하려는데 어떻게 하나요?	아직 체크인할 시간이 아니라 한 시간 정도 기다리셔해요
혹시 네이버 페이도 되나요?	이버 페이는 지금 안됩니다
청소년은 몇 시까지 이용 가능해요?	청소년은 저녁 10시까지 이용 가능합니다
현금이랑 카드 모두 되나요?	무인정산기에서 결제하실 수도 있습니다
한 장에 얼마예요?	컬러는 100원 흑백은 50원입니다
날짜가 어떻게 되세요?	다음주 일요일부터 수요일 까지
몇 박 하실 건가요?	하루요
펜션에는 또 어떤 게 있죠?	바비큐 하려면은 저희가 숯불 피워드려요
오늘, 내일 1박 2일 예약한 사람인데요	펜션 안내해 드릴게요
방에 보일러는 잘 되나요?	보일러는 잘 돌아가요
공부를 안 할라 카니까 그 쪽으로 당구쪽 함 시켜보려는데요?	그것도 좋은 방법이에요
지금 방 있나요?	빈 방 있어요
예약확인번호와 성함을 알려주시겠어요?	김창선 20180420입니다
커피숍 이용 시간은 몇 시부터 몇 시까지인가요?	커피숍은 오전 여덟 시부터 오후 열한 시까지 가능하세요
어떤 스타일의 방으로 드릴까요?	모던 룸으로 주세요
세면도구, 수건도 다 있나요?	칫솔이랑 치약은 가져오셔야 해요
카드 결제 되나요?	카드 받았습니다
3일 예약하고 싶은데 가능한가요?	3일자로 예약해드릴게요
조식은 없는데 이박 하신다고 그랬죠?	이박 하려고요
2인실 침대방으로 할 게요	방에 혹시 아기침대도 있나요?
바비큐 시설 이용할 수 있나요?	가능해요
스위트룸 예약했는데, 확인 좀 해주실래요?	스위트룸 이박 삼일 예약하셨네요
회원제인가요?	회원가입 후 이용하시면 됩니다
7일 정도 숙박하려는데 조금 할인이 안될까요?	25만 원으로 해드릴게요
지금 바로 계산하겠습니다	편히 쉬세요
방음은 되나요?	방음은 잘 되어 있어요
신관은 어디로 가나요?	복도 끝 엘리베이터 이용해 주세요
아무 데나 앉으면 될까요?	편한 자리에 앉으시면 됩니다
오늘 하루 숙박요금 얼마인가요?	숙박은 40000원이에요
묵으시는 분 몇 명이세요?	5명이요
휴대폰 뒷 번호가 어떻게 되시지요?	2박 3일 싱글룸으로 예약하신 거 확인되셨어요
저녁에 바비큐도 쓰실 거예요?	오늘 저녁에만 이용할게요
음료수도 좀 가져다주세요	음료는 셀프입니다
요금은 한 시간에 얼마에요?	한 시간 십분에 1000원이에요
칫솔도 있나요?	칫솔은 가지고 오셔야 해요
방 하나 주시고 얼마죠?	대실은 2만 원이에요
혼자서 묵을 수 있을까요?	혼자서 묵으실 수는 있는데 2인용 방이라 가격이 비싸요
더블 침대 2개 있는 방 얼마죠?	하루에 120000원이에요
펜션 다음 주 숙박이 가능한가요?	다음 주 목요일, 금요일에는 가능해요
다행히 아직 남아있는데 몇 층을 선호하시나요?	되도록이면 고층이 좋습니다
엑셀로 자료를 좀 뽑으려면 한 장당 얼마나 하나요?	장당 삼백 원요
몇 분이세요?	저 혼자입니다
이용요금은 얼마인가요?	여덟명이시면 이십팔만원 정도 돼요
컴퓨터 사양은 유행하는 배틀그라운드같은 게임 다 돌아갈 정도 되나요?	배틀그라운같은 게임 다 돌아갑니다
당구장 흡연 가능한가요?	저희 당구장은 금연입니다
여기 음식도 배달시켜 먹어도 되나요?	여기 목록에 있는 집만 가능합니다
당구대가 기울어진 것 같아서요	조금 그런 것 같네요
체크아웃은 언제까지인가요?	체크아웃은 오후 4시에 하셔야 해요
라면이랑 콜라는 자리에서 결제 가능하죠?	가능합니다
일행이 좀 늦는데 연습볼 좀 치고 있어도 돼요?	10분 이상은 안 됩니다
여기 피씨방 영업시간이 언제부터 언제까지예요?	24시간이요
태풍 때문에 취소된 예약 금액을 전액 환불받을 수 있는 건가요?	자연재해로 발생된 거라 환불 가능해요
그럼 회원가입하고 정액제 이용할게요	알겠습니다
낮에 나가시나요?	낮에는 생활해야하니까
따로 할인 이벤트 하고 있는 건 없나요?	카카오 페이로 결제 시 1% 캐시백 드리는 할인 이벤트는 진행 중에 있어요
그럼 당구장에서 음식을 시켜 먹을 수 있나요?	중국집이나 배달 가능한 곳에서 시켜 드시면 되세요
몇 명이서 숙박하세요?	가족 3명이서 숙박합니다
애하고 삼인 가족인데, 전망 좋은 데로 하면 객실 이용료가 얼마나 되나요?	토요일은 객실료가 십 이만 원이에요. 조식 포함하시면 십육만 팔천 원에 이용 가능하세요
성함이 어떻게 되시나요?	홍길동입니다
건물 주위에 주차 할 수 있는 곳 있어요?	건물 지하주차장에 주차하시면 돼요
음식 주문은 자리에서 하면 되나요?	주문하시면 자리로 갖다 드려요
캠핑장 제일 안 쪽 자리 잡을 수 있나요?	제일 안쪽 자리는 이미 다른 분이 예약되어 있고, 그 다음 자리로 드릴게요
이동할 수 있는 차도 있나요?	차는 가져오셔야 해요
삼월 이십구일 예약이 가능한가요?	금요일 세명이면 예약 가능해요
근처에 볼만한 곳 있나요?	관광지는 많아요. 불국사, 안압지, 보문단지가 근처에 있어요
청소도 매일 해주시죠?	원하시면 청소는 매일 해 드려요
스위트 객실, 이용료는 얼마인가요?	스위트 객실은 팔만원이요
혹시 PC사양은 어떻게 돼요?	사양은 다 똑같은데 화질이나 이런거 조금 따지시면 이쪽 자리에 앉으시면 돼요
화장실이 어디 있나요?	화장실 구비되어 있습니다
체크아웃 시간은 어떻게 돼요?	다음날 오전 열한 시에 퇴실이에요
오월 사일 말씀이세요?	오월 사일이에요
방이 2층에 하나 3층에 하나 있는데 어디로 드릴까요?	2층은 지금 청소 중인데 10분만 기다려 주세요
무료로 제공되는 음료 있나요?	물은 객실 냉장고에 제공해드리고, 이 외에 다른 음료는 없어요
호텔 밖에 식사할 수 있는데 아시는 곳 있나요?	여기는 거의 술집이라서 간단한 국밥은 있어요
조식 포함되어 있는 거 맞죠?	조식은 7시 30분부터 이용 가능하세요
회원가입을 해야만 이용이 가능한가요?	비회원도 가능합니다
네 몇 분이세요?	두 명이에요
네 9번으로 1시간 적립해 드릴까요?	천원 받았습니다
수건 한 장 더 주실 수 있나요?	한 장 더 드릴게요
한 명 추가비 얼마정도?	만 원이에요
중간에 멈춰두고 쉴 수 있나요?	그건 불가능합니다
거기 몇층인가요?	꼭대기 층이에요
20번 vip 좌석은 추가요금이 있나요?	회원이시면 언제든 이용 가능하십니다
4인 기준이라 1인에 대한 추가요금 있는데 괜찮으신가요?	괜찮아요
몇 분이서 묵으시나요?	3명이요
급하게 묵을 곳이 필요한데 혹시 오늘 방이 남아있나요?	제일 작은 방 하나 있어요
여기 말고는 다른 곳 있나요?	내려가서 저기 옆에 당구장 있어요
로그인하셔서 보여주실래요?	여기 확인해 주세요
컴퓨터 사양때문에 그런데 그래픽카드는 어느정도 쓰시나요?	배틀그라운드 전용석은 그래픽카드가 1080티아이인데 일반석은 그래픽카드를 1060 사용합니다
체크인 시간은 언제예요?	체크인은 3시부터이고 체크아웃은 뒷날 11시까지예요
객실에서 음식을 만들어 먹어도 되나요?	죄송하지만, 객실에서는 조리가 금지되어 있어요
몇 명이신가요?	4명입니다
후불제도 가능한가요?	선불만 가능합니다
대여료가 얼마인가요?	3만 원이에요
총 10명 객실 A 예약하신 거 맞으신가요?	맞습니다
바비큐는 얼마인가요?	20000원이에요
체크인 시간이랑 체크아웃 시간이 몇 시예요?	체크인 시간은 오후 세 시부터, 체크아웃은 열두 시 이전까지예요
4명이 함께 앉을 수 있나요?	확인해보겠습니다
주차는 몇 대까지 가능한가요?	1대까지 무료로 주차 가능해요
입실 시간이 언제입니까?	오후 2시부터 입장할 수 있어요
출력 먼저 하고 카운터에서 계산하면 되지요?	출력하고 카운터로 오셔서 계산하시면 됩니다
펜션 예약 가능한가요?	가능해요
죄송한데 잘못 나와서 다시 인쇄할게요	조금 전 이용하셨던 컴퓨터로 인쇄하시면 됩니다
사이트가 넓은 곳으로 예약 좀 해주실래요?	그러면 A 사이트 예약하셔야 해요
컴퓨터 사양은 배틀그라운드 다 돌아갈만한 사양인가요?	전 좌석 배틀그라운드 다 돌아갑니다
계산은 카드도 가능한가요?	카드는 받고 있지 않습니다
결제 되나요?	결제 해드릴게요
여기 와이파이는 다 설치되어 있나요?	와이파이 다 설치되어 있습니다
회원가입을 해야지만 이용이 가능한가요?	비회원도 이용 가능하세요
사장님 포켓볼 테이블 있나요?	마침 한 테이블 비었네요
체크인 되나요?	약확인 위해 신분증 부탁드릴게요
언제까지 있을 수 있나요?	다음 날 오전 11시까지 계실 수 있어요
지금 입실 가능한가요?	키 드릴게요
수건을 더 주실 수 있나요?	더 드릴 수 없어요
성인 두 분이세요?	숙박비용이 궁금한데
성함이랑 전화번호 뒷자리 알려주세요	강은선이고 0408입니다
일행분들이 덩치가 크나요?	중고등 학생 하고 성인 두 명씩 총 여덟 명이거든요
호텔 조식 시간은 언제입니까?	저희 호텔은 조식을 6시 반부터 8시까지 운영하고 있어요
칫솔도 있나요?	칫솔이 있는데 보통 가지고 오시는 분이 많아요
공휴일에도 영업하시구요?	1년 무휴에요
몇 분입니까?	가족 룸이 있어요
대여 가능한 캠핑 도구의 목록을 알 수 있을까요?	캠핑장 홈페이지에서 확인 가능하세요
당구 채 그냥 주시면 안 되나요?	안됩니다
빈자리 앉으면 되나요?	편하신 곳에 앉으시면 됩니다
토요일은 얼마고 일요일은 얼마에요?	토요일은 육만 원이고 일요일은 오만 원이요
비품 같은 것도 요청하면 다 주나요?	달라고 하면 일회용품 다 드려요
2박 예정인데 연박 가능한가요?	연박 가능해요
음료는 어떤 거 드릴까요?	여기 있습니다
오늘 몇 시까지 영업해요?	10시까지 오시면 되세요
여기는 1시간에 얼마 받나요?	1시간에 만 2천 원 받습니다
성함 알려주세요	박고순 입니다
호텔 안 편의시설 말씀이세요?	호텔 안 편의시설이요
너구리랑 신라면이요	준비되면 자리로 갖다 드릴게요
혹시 바비큐 시설 이용하려면 별도의 추가 요금이 있을까요?	2인 기준 2만 5천 원 추가 요금 있어요
혹시 주차공간이 있을까요?	건물 지하에 주차공간이 있기는 한데 차가 8대 밖에 안들어가요
펜션 근처 가볼 만한 곳이 있나요?	가까운 거리에 갈 곳이 많아요
시간당 얼마인가요?	만 원입니다
사월 십삼일에 예약이 가능한가요?	삼월 삼십일부터 사월 둘째 주까지 벚꽃 축제 시즌이에요. 제가 예약 담당하는 부서 연락처 알려드릴게요
대실은 얼마인가요?	대실 비용은 2만 원이에요
여기 혹시 피씨방 영업시간이 어떻게 되십니까?	영업시간은 24시간입니다
당구 큐대는 무료로 사용할 수 있나요?	오른 편에 있는 당구 큐대 쓰시면 되고 사용 다 하시고 다시 꽂아 놓으시면 돼요
1박에 얼마예요?	1박에 50000원이에요
나가면서 계산해도 되죠?	괜찮습니다
쓰레기는 분리수거해야 하나요?	재활용 가능한 것은 분리해서 버려주세요
휴대폰 충전기를 빌리고 싶습니다	본인 신분증 맡기시고 대여해 가시면 돼요
음식 주문도 가능한가요?	음식 주문은 자리에서 고르시고 주문 하시면 됩니다
숙박은 며칠 하실 건가요?	오늘 하루만 할게요
오월은 조식 포함한 패키지 가격이 나와 있지 않은데, 조식도 포함하시나요?	패키지가 안 되면 제가 따로 신청해야 되는 거잖아요
예약은 가능한가요?	예약 가능합니다
요금이 어떻게 되나요?	30분당 3천 원입니다
빈방 있나요?	빈 방 있어요
자가용으로 이동하는 게 편할까요?	여기 펜션은 자가용으로 오는 게 좋죠
현재 숙박 중이신 방이 302호이신가요?	번거로우시겠지만 다른 방으로 교체해드릴게요
일반 모텔하고는 다른데, 우리 모텔에서 숙박하신 경험이 있나요?	여긴 처음이에요
계산은 카드도 가능한가요?	카드 결제 가능합니다
여기 혹시 영업시간이 언제부터 언제까지 인가요?	저희 피씨방은 24시간 영업합니다
야 놀자 어플 할인과 쿠폰 할인 중복 적용이 되나요?	중복할인은 안돼요. 둘 중 하나만 사용하실 수 있어요
삼성페이나 카카오페이도 가능한건가요?	페이 결제는 아직 신청하지 않았어요
여기 혹시 피씨방 영업시간이 언제까지 인가요?	피씨방은 대부분 24시간 영업입니다
일행분 언제 오시나요?	우선 테이블 하나만 빌릴게요
펜션에 와이파이 되나요?	저희는 와이파이 돼요
여기 카드 결제 할 수 있나요?	1000원 이상이시면 가능합니다
좌석은 어디에 있죠?	왼쪽 구석에 있어요
호텔 측에서 무료 음료 제공하는 게 있나요?	무료 음료는 생수가 들어가고 있어요
이인실에 네 명이면 요금은 어떻게 되죠?	토요일은 주말 가격이라서 십이만 원이요
계산은 각각 해주세요	각각 계산 도와드릴게요
주차는 어디에 해야 하죠?	지하주차장 이용해주시면 돼요
배틀그라운드 잘 돌아가죠?	물론입니다
이틀 숙박하면 할인 되나요?	죄송합니다만, 그런 이벤트는 없어요
그럼 라면 취소해주시고 그걸로 지금 가져다주세요	빨리 가져다드릴게요
몇 분이 이용하시나요?	금연석과 흡연석이 있습니다
당구장이 스타벅스 건물 4층에 있는 거 맞나요?	맞습니다
모 식당은 몇 시부터 열어요?	아침 6시 30분부터 이용 가능해요
아 장갑은 어디에 있어요?	저쪽 카운터 옆에 있습니다
애가 몇 살 정도 되죠?	이제 중학교 이학년이요
짐이 많은데 방으로 부탁드리겠습니다	직원을 불러드릴게요
음식 시키면 여기서 직접해서 갖다 주시는건가요?	저희가 직접 조리해서 갖다 드립니다
언제쯤 다시 전화 예약 드리면 될까요?	전화 예약은 한 달 전에 주시면 제일 좋죠
얼마인가요?	총 2시간 20000원입니다
결제는 삼성페이 되나요?	결제해드릴게요
그곳에서 가장 가까운 지하철역 출구가 몇 번인가요?	3번 출구로 나오시면 됩니다
와이파이는 다 설치되어 있나요?	와이파이 전 좌석 다 되어있으세요
주말에는 가격이 여기서 더 올라가나요?	주말이나 공휴일은 십만 구천 원이에요
3월 중순, 주말이에요? 주중이에요?	3월, 주중이요
청소년들은 몇 시까지 사용이 가능한가요?	청소년들은 10시까지 사용 가능합니다
캠핑장 이용 가능한가요?	이용 가능해요
회원가입을 해야지만 사용이 되나요?	비회원도 이용 가능해요
바비큐는 저희가 재료를 준비해서 가야 하죠?	먹을 거만 사 오시면 불피워주고 어른 2인에 만오천원 받고 숯불 피워서 가져다드려요
그런데 시간이 빨리 줄어드는데 왜 그렇죠?	지금 하시는 게임 가맹점이라 그렇습니다
오션뷰로 부탁드립니다	오션뷰로 예약 해드릴게요
한 달 정도 장기 투숙 가능한가요?	선불로 결제하시면 장기 투숙이 가능해요
회원가입은 어떻게 하나요?	핸드폰 번호로 인증하시면 가입하실 수 있어요
초크를 새 걸로 바꿔주세요	초크 새걸로 바꿔드리겠습니다
객실에서 와이파이 되나요?	객실 안에 설치되어있어요
조금만 상의하고 다시 전화드릴게요	전화 주세요
회원가입을 해야지만 이용이 가능한가요?	비회원도 이용할 수 있습니다
몇 분이신가요?	저 혼자입니다
결제는 이따가 같이 해도 되는 거죠?	그러세요
오늘 예약했는데, 확인 좀 해주실래요?	12일부터 14일까지 2박 예약하신 걸로 확인되세요
룸에 세면도구 제공되나요?	룸 안에 구비되어 있어요
삼성페이나 카카오페이도 혹시 가능한가요?	삼성페이 카카오페이 다 가능합니다
당구대 하나로 괜찮으실까요?	저희가 많이 왔어도 몇 명만 칠 거라서 괜찮습니다
일반실은 5만 원이고 특실은 8만 원인데, 어느 방으로 드릴까요?	특실로 안내해 드릴게요
이용요금이 얼마인가요?	2인이면 12만원이에요
체크아웃은 몇 시까지인가요?	아침 11시예요
네, 언제로 해드릴까요?	20일 1박이요
프린트는 한 장당 얼마에요?	흑백은 100원씩입니다
패밀리룸으로 예약했는데, 확인 해주실래요?	오늘부터 3일간 예약되셨군요
조식은 나오나요?	식당이 있어서 조식은 제공되지 않고 10% 할인받을 수 있어요
사우나는 몇 시부터 몇 시까지예요?	사우나 이용 시간은 오전 일곱 시부터 오후 열 시까지예요
조금 일찍 도착했는데 지금 체크인 되나요?	예약한 자리 바로 이용하시면 돼요
사월 십삽일 일박 이일로 예약 가능한가요?	제일 큰 객실이 사인실 스위트룸이라서 스위트룸 하나 스탠다드룸 하나 이렇게 하셔도 되고 스탠다드룸 세 개를 쓰셔도 돼요. 사월 십삼일 자 스위트룸 금액이 지금 육십일만원이고 스탠다드룸 같은 경우에는 이십일만원이에요
학생증 보여주세요	여기 있습니다
캠핑 추가 하려면 얼마인가요?	5만 원이에요
카카오페이도 결제 가능해요?	카카오페이는 안 되고, 삼성페이는 돼요
오늘은 가능한데 내일은 예약이 완료되서 안되는데 괜찮으세요?	그럼 오늘 1박만 일단 하겠습니다
음식 주문은 자리에서 이렇게 하면 되나요?	카운터에서 해도 상관은 없습니다
음식배달도 시켜먹을 수 있고요?	가능해요
트윈룸과 더블룸 중 어느 쪽이 좋으신가요?	트윈룸으로 주시고 선택 가능하면 샤워 부스 있는 욕실로 주세요
이 영수증으로 확인하는 건가요?	영수증 하단에 표시된 아이디를 사용하고자 하는 컴퓨터에 입력하면 됩니다
숙박 비용이 대략 얼마인지 말씀을 해주실 수 있어요?	사월 십삽일 같은 경우에는 극성수기 주말이라 스탠다드룸 두 분 기준에 구만원이에요
얘약 대기 걸어도 될까요?	혹시라도 취소하시는 분이 계시면 연락드릴게요
화장실은 어디에 있나요?	나가셔서 오른쪽으로 꺾으시면 됩니다
체크인 시간은 몇 시에요?	체크인은 평일에는 두시에 가능하세요
흡연실도 따로 있나요?	흡연실은 바로 앞 여기 보시면 있습니다
큰 텐트를 치면 가격이 올라가겠네요?	사이즈가 크면 가격이 비싸죠
현재 숙박 중이신 방이 302호이신가요?	추워서 잠을 잘 수가 없어요
할인 같은 건 없나요?	대학생은 1500원이에요
방은 어디에 위치했나요?	2층 복도 끝 201호예요
라면 파나요?	2가지 종류 있습니다
제휴 할인되는 카드는 없죠?	할인 카드는 없어요
펜션 내에는 수건이나 샴푸 같은 생활용품이 있나요?	기본적인 생활용품이 완비되어 있고 전부 사용 가능해요
함께 써도 괜찮은데, 그 방은 있어요?	큰 룸은 22만원이에요
6명인데 할인 안 되나요?	그럼 한 명당 500원씩 할인되셔서 총 27000원 결제해드리겠습니다
너무 짧게 칼같이 주시네요	요즘 이상한 손님들이 많아서 어쩔 수 없이 제한을 걸었습니다
카카오페이 결제가 가능한가요?	카카오페이 부분은 프런트에서 문의하세요 연결해 드릴게요
4시쯤에 입실 할 수 있나요?	토요일 오후 3시로 예약 잡을게요
몇 박 하실 거예요?	1박이요
여기 와이파이 비밀번호 어딨어요?	와이파이 비밀번호는 W12345678 입니다
혹시 후불도 가능한가요?	선불만 가능합니다
바비큐장은 있어요?	바비큐는 마당에서는 가능하고 준비는 다 해드리고 있으니까 재료들만 사 오시면 돼요
주차도 되나요?	가능해요
체크인 시간 몇 시에요?	체크인은 오후 세 시부터 가능하세요
캐라반 이용 시 전기요금 따로 없죠?	캐라반 사용해도 전기요금 없어요
주말에는 4명 얼마에요?	주말에는 4명 10만원이에요
아침은 주나요?	조식은 없어요
주류도 구입 가능한가요?	미리 말씀해주시면 같이 준비해둘게요
2만 원만 내면 바비큐 파티에 그냥 몸만 가면 되나요?	전부 준비되어 있어요
고층으로 부탁드려도 될까요?	업그레이드하셔서 1508호실입니다
그러면 청소년들은 몇 시까지 이용이 가능합니까?	청소년들은 10시까지 이용 가능합니다
그럼 가르쳐 주고 이런 거 없이 친구랑 와서 치면 되네요?	같이 하면 됩니다
인원이 몇 분이죠?	인원은 4명이요
혹시 맛있는 집 번호 아세요?	여기로 전화해보세요
마시는 물은 어디 있나요?	왼쪽 보시면 냉장고에 음료 늘 무료로 이용하시고 생수는 그 옆에 있습니다
체크인은 몇 시부터 가능한데요?	지금 방 비어있으니까 언제든지 오시면 돼요
그러면 청소년들은 몇 시까지 이용 가능한가요?	10시까지 가능합니다
30분 단위로도 가능해요?	1시간 단위로만 가능해요
투숙은 몇 명이 하시나요?	2명이 할 예정입니다
연박시 할인 가능한가요?	연박 할인은 해 드리지 않아요
요금이 어떻게 되나요?	저기 표에 있어요
1박에 얼마인가요?	1박에 4만 원이에요
6명이 숙박할 수 있는 방이 있나요?	기본 4인인 방이 있는데 인원 추가 2명까지 가능해요
흡연 가능한가요?	실내에서는 불가능하고, 바로 옆에 흡연실이 따로 있습니다
캠핑장에서 바비큐 구워 먹어도 되나요?	가능해요
뷰가 보이는 방은 조금 더 비싼가요?	전망 좋은 방은 가격이 높아요
한 시간에 얼마인가요?	시간당 1500원입니다
퇴실은 몇 시까지 하면 될까요?	퇴실은 11시까지 하시면 돼요
이용방법은 어떻게 하면 되나요?	카들 들고 가셔서 이용하시면 돼요
팔만 원이 조식을 포함한 가격인가요?	저희는 따로 조식이 없고, 일층에서 식당이 별도로 운영되고 있어요
안에 세안용품이랑 다 있나요?	세안용품은 별도로 구매하셔야 해요
주차시설은 따로 없으시구요?	주차시설은 따로 없습니다
회원가랑 비회원가랑 다르죠?	한 시간에 200원가량 차이 납니다
편의시설 어떤 거 좀 이용할 수 있나요?	호텔 안에 편의시설은 없어요
프린트 한 장에 얼마예요?	흑백은 500원 칼라는 1000원이에요
비흡연석 있나요?	좌측 좌석은 모두 비흡연석이에요
햄버거 세트 얼마에요	5500원이에요
체크아웃 시간은 언제인가요?	오전 10시예요
4구 한 시간에 얼마입니까?	한 시간에 만 이천 원입니다
카드로 결제해주실래요?	카드 받았고, 무이자 결제해드릴게요
당구장 예약도 혹시 가능한가요?	원하시면 예약도 해드리고 있어요
아직 고기가 많이 남았는데 불판이 다 탔어요. 어떡하죠?	임시로 이 프라이팬을 사용하고 계시면 제가 불판을 사다 드리도록 할게요
체크아웃 시간은 몇 시인가요?	오전 11시예요
선불로 하고 싶은데요	화면 오른쪽 위에 선불 이용 버튼 있습니다
다음 달에 캠핑장 예약하고 싶은데 어느 날짜가 비성수기인가요?	다음 달 4일부터 17일까지 비성수기에요
취사도구 대여 시 따로 비용이 추가되나요?	무료예요
몇 명이세요?	어른 2명 아이 2명 총 4명이요
구비되어 있는 편의용품은 리필이 가능한가요?	편의용품은 샴푸나 바디워시, 비누 정도 있는데 리필은 안 되고 샤워 타올이나 칫솔, 치약은 유료이기에 가지고 오셔야 해요
성함이 어떻게 되세요?	예약 확인되셨어요
욕실 용품은 다 들어가 있고요?	다 있어요
장갑 어디에 있어요?	이쪽에 있습니다
청소년들은 몇 시까지 이용할 수 있어요?	청소년들은 10시 이후에는 나가야돼요
공항으로 픽업도 해주시나요?	셔틀버스나 공항 픽업은 따로 없어요
근처에 볼만한 관광지 있나요?	경주 어지간한 곳은 가까워요
카드로 하시겠어요?	현금이요
현금 할인은 안 되나요?	현금 할인은 따로 없어요
날짜는 언제세요?	16일에는 객실이 없어요
예약자 성함이 어떻게 되세요?	김철수요
계산은 혹시 카드로도 가능할까요?	카드로 계산 가능합니다
네, 삼성페이 결제되죠?	삼성페이 결제 가능해요
5시간 정액제 하려 하는데 어떻게 하는 거죠?	5시간 누르시고 결제방법 선택 후 결제하시면 됩니다
성함이 어떻게 되시죠?	박철수입니다
카드로 계산이 가능한가요?	카드도 받고 있어요
수강하는데에 더 필요한 거는 없어요?	혼자 쓰는 개인 큐는 필요해요. 그거는 이제 부모님이 하나 장만해주던지 하시면 돼요
하루 묵는데 비용이 얼마인가요?	1박에 만 오천 원이에요
그 방 가격은 어떻게 되는데요?	거긴 스탠더드룸이라 요금은 조금 저렴해져요
김치볶음밥 주문할게요	10분 뒤에 자리로 가져다드릴게요
바베큐장 이용 6시로 준비 부탁드립니다	준비 해 둘게요
할인되는 방은 없나요?	할인된 가격으로 안내해 드린 금액이에요
현금영수증 해주세요	앞쪽에 번호 눌러주세요
세면도구는 구비가 되어있죠?	세면도구는 다 되어 있고 칫솔만 가져오면 돼요
사월 이십일 예약 가능한가요?	패밀리 디럭스가 사인실인데 더블 침대 두 개가 있는 객실로 예약이 가능하세요
방 있어요?	방 두 개 있어요
열선 있는 다이가 어떤 거인가요?	모든 당구대에 열선이 설치되어 있습니다
와이파이는 다 설치되어 있나요?	와이파이는 다 설치되어 있어요
며칠 투숙하실 건가요?	2박 하려 합니다
저녁 바비큐 시간이 몇 시부터죠?	6시부터 가능해요
하재현하고 김지원 두 명 얼마에요?	두 분 7100원 나왔습니다
체크인 시간 전에 가서 짐을 맡기는 것도 가능한가요?	오셔서 예약자분 성함 말씀하시고 맡겨주시면 돼요
빈 방 있나요?	빈 방 있어요
스파 가능한 객실로 예약 되나요?	스파 가능한 객실로 안내해드릴게요
네, 성함이 어떻게 되세요?	김철수로 예약했습니다
제가 회원이 아닌데 비회원은 얼마인가요?	시간당 2000원입니다
얼마인가요?	이만 원입니다
스프링클러는 설치가 되어있죠?	스프링클러는 소방법에 따라서 구비가 되어 있어요
체크아웃은요?	체크아웃은 다음 날 오전 열한 시까지 해주시면 되세요
언제 사용하실 건가요?	이번 주 토요일에 될까요?
칫솔하고 면도기는 따로 구매해야 하나요?	칫솔하고 면도기는 구매하셔야 해요
새벽이라 사장님이 전화를 안 받아오셔서 그런데 연락처 주실 수 있어요?	제 번호는 010에 7777에 7777입니다
지금 4자리 있어요?	오른쪽 구석 끝으로 가세요
몇 분이시죠?	4명이요
4월 6일, 1박 2일로 4인 가족이 이용하려고 하는데 요금이 얼마나 되나요?	20% 할인되어 방마다 다른데 복층 방에 들어가서 인원을 넣으면 자동으로 금액이 나와요
텔레비전은 다 있나요?	텔레비전은 방마다 다 있어요
욕조도 있고요?	욕조 있어요
b방 3일 m포인트로 결제 되나요?	비밀번호 입력해주세요
와이파이 비밀번호가 어떻게 되나요?	여기에 적혀져 있습니다
바비큐 숯은 몇 시에 해주시나요?	5시부터 원하는 시간에 해드려요
고기 같은 것들은 준비해서 가야 하죠?	주변에 마트가 있어요
비상구는 어느 쪽에 있나요?	저기 가운데 보시면 비상구 있습니다
패밀리룸이 몇 층인가요?	8층 809호로 가시면 돼요
빈자리에 앉으면 되나요	비번 드릴게요
객실 말이세요?	룸 예약하려고요
몇 명이 오셨죠?	어른 두 명 아이 3명이요
흡연실은 어디에 있나요?	흡연실은 여기랑 이쪽에 있습니다
조식 서비스도 같이 포함된 가격인가요?	죄송하지만, 조식은 따로 지불하셔야 돼요
요금은 한 시간에 얼마 정도 되나요?	회원이랑 비회원이랑 조금 달라요
방 구하기가 왜 이리 힘들어요?	요즘 축제 기간이라 객실이 다 만실이에요
예약을 하려면 며칠 전에 전화드려야 해요?	주말은 방이 잘 없으니까 미리 하시는 게 좋아요
욕실용품 리필 되나요?	욕실용품은 리필해 드리지 않아요
네 4구인가요 3구인가요?	4구로 하나 주시고 장갑도요
지금 회원가입은 어디서 해야하나요?	회원가입은 자리에서 하시면 됩니다
아까 그 방으로 할게요. 얼마죠?	4만 원이에요
바비큐 추가 인당 만 원 해서 3만 원 인가요?	고기는 무한리필이니 마음껏 드실 수 있어요
혹시 회원가입을 해야지만 이용이 가능한가요?	비회원으로도 이용 가능합니다
짐 보관하는 곳이 따로 있나요?	따로 없고 카운터 뒤에 보관해드리겠습니다
그럼 요금은 한 시간에 얼마정도인가요?	비회원은 900원입니다
욕실용품은 제공이 다 되는가요?	욕실용품은 다 있습니다
일박 현금하면 십일만 원이라고 하셨죠?	현금 십 일만원에 드릴게요
그럼 중국집에서 시킬게요	여기 메뉴 드릴게요
조식은 몇 시까지 먹을 수 있나요?	조식은 아홉시 반까지 해요
컵라면 하나랑 콜라 하나 주세요	자리로 가져다드리겠습니다
회원가입하실 건가요?	혹시 문제 있으면 불러주세요
냉장고도 다 구비가 되어있죠?	방에 냉장고 있어요
재떨이도 주시면 감사하겠습니다	바로 드리겠습니다
원룸 형태는 괜찮으신가요?	원룸 형태인데 한옥 독채라 6명 가능해요
어떤 룸 원하세요?	지금 고층 룸은 풀 부킹 상태에요
4월 6일이 맞으신가요?	4월 6일이요
다음주 금요일 숙박 가능한가요?	1박이시면 다음주 금요일 숙박 가능하세요
역 근처에서 장 보고 있어도 픽업 되나요?	그쪽으로 가서 기다리겠습니다
그 일주일 씩 있어도 해도 가격은 똑같고예?	같아요.
컵라면, 햄버거, 콜라 결제 좀 해주세요	3900원입니다
여기 며칠동안 숙박할라 하는데, 하루에 얼마씩해요?	저희 지금 평일에는 삼만원이에요
혹시 음식도 주문도 자리에서 가능할까요?	주문도 자리에서 가능합니다
서비스 음료 없나요?	아이스티랑 커피 있어요
공항 셔틀버스 이용할 수 있나요?	저희는 셔틀버스 따로 없어요
퇴실 시간은 언제예요?	오전 11시까지 퇴실하셔야 해요
주말에는 프린트 하려면 비용이 얼마나 들어요?	흑백은 삼백 원, 컬러는 오백 원 이렇게 되거든요
혹시 커플석 있나요?	따로 지정된 데는 없고 그냥 아무데나 같이 앉으시면 돼요
숙박비는 카드로 결제하실 건가요?	현금 결제하겠습니다
화장실은 어디 있나요?	나가서 왼쪽입니다
특실은 얼마인가요?	특실은 1박에 10만 원이에요
아까 말씀 주신 룸이 온돌방인가요? 침대방인가요?	침대 있는데 부족하시면 침구류는 따로 드려요
금요일날 대기예약을 신청해 놓으면 예약이 가능할까요?	저희가 대기예약 시스템은 따로 없어서 안 되세요
저희가 처음 해보는데 어떻게 해야 더 재밌을까요?	그럼 2명씩 팀을 짜서 하는 게 더 재밌어요
카카오페이나 삼성페이도 혹시 가능한가요?	카카오페이나 삼성페이로 계산 가능합니다
음료수 갖다 주시나요?	자리로 갖다 드릴게요
몇 분 오세요?	총 세명이에요
1박 2일로 3월 중순에 갈까 하는데 요금은 얼마 정도로?	3월 주중이면 7만원이에요
컴퓨터가 잘 안되는데 자리 옮겨도 되나요?	컴퓨터 사용 정지하신 후에 옮겨주세요
오늘 객실 남은 게 있나요?	오늘은 신관 301호에 묵으시면 되세요
여기 회원가입해야돼요?	자리에 가셔서 회원가입 하시면 돼요
주말에는 보통 주중 평일 때보다 가격이 더 비싸죠?	주중에 오만 원이면 주말에 십만 원 넘을 수도 있어요
일시불로 해주세요	일시불로 결제해 드릴게요
냄비라면으로 주시고 여기 프린트되나요?	칼라 500원 흑백 200원입니다
다른 먹을 거는 사 가는데 숯을 사용하면 추가 비용이 있나요?	숯은 성인 두 명에 기본이 이만 오천 원이고 한 사람 추가될 때마다 오천 원씩 추가돼요
혹시 여기 앞에 주차 해놔도 괜찮아요?	되긴 되는데 주차장에 관리하는 분이 있어서 만약 무슨일 생기면 번호로 전화올 거에요
요금은 시간당 요금인가요?	한 명당 한 시간에 5000원입니다
지금 방 있나요?	잠시만요, 빈 방이 있는지 확인해볼게요
사장님, 10분에 얼마에요?	10분에 천오백 원이요
베틀그라운드라든지 이런 게임은 다 돌아가나요?	베틀그라운드 같은 게임 다 돌아갑니다
흡연실은 따로 구비되어 있나요?	구비되어 있어 흡연실에서만 흡연이 가능하세요
혹시 간식류 제공해 주시나요?	음료수 서비스 드리고 있습니다
펜션 위치가 어디쯤인가요?	저희 펜션은 보문관광단지에 한화리조트, 현대호텔 다 모여 있는데 거기 가기 한 코스 전에 있어요
금액 조금 깎아 주시면 안 돼요?	지금 세일해서 할인은 된 거예요
바비큐 할 때 고구마나 감자 같은 것도 주시나요?	20000원에 다 포함되어 있어요
그러면 음료수는 뭘 드릴까요?	죄송하지만 사이다가 떨어졌습니다
몇 시까지 체크아웃 해야 하나요?	내일 오전 11시까지 체크아웃하시면 돼요
중간에 음식을 먹을 수 있습니까?	배달시키시면 됩니다
방은 어떤 거로 예약하실 건가요?	아이들이 있어서 온돌방으로 원합니다
우성빌딩, 그 안에 있는 당구장에서 배울 수 있나요?	옛날 상인 나이트 건물에요
성인 네 분이세요?	아니요, 아이들 두 명하고 성인 두 명이요
일반실과 특실이 있는데, 어느 방으로 드릴까요?	특실에서 묵고 가겠습니다
흡연실도 따로 있나요?	흡연실 따로 있습니다
네, 몇 분이신가요?	2인실 있어요
방 있어요?	방 있어요
쓰레기는 어디에 버립니까?	캠핑장 내 분리수거장에 버리시면 돼요
담배 피면서 해도 괜찮나요?	흡연실이 따로 있어서 당구장 안은 금연구역입니다
와이파이는 다 설치되어 있나요?	초고속 와이파이로 설치되어 있어요
캐라반은 사용할 수 있나요?	캐라반 있으면 가능해요
제휴 할인 카드가 있나요?	저희는 제휴 할인이 없어요
사이트 예약하려고 하는데,어떻게 하나요?	예약 문자 보내드리겠습니다
혹시 담배 파는 곳 아시나요?	바로 앞에 편의점 있어요
자리 있나요?	조금만 기다리시면 3번 자리가 나옵니다
네 기다릴게요	음료수 드시면서 기다리세요
일회용품 필요하세요?	주시고 같이 계산해주세요
컵라면 하나 부탁해요	그럼 준비해서 자리로 갖다 드릴게요
6인 이상 쓸 수 있는 객실이 있나요?	다인 실을 이용 가능해요
그럼 가격차이가 있나요?	회원가가 더 저렴합니다
포켓볼도 치려고 하는 데 자리 있나요?	그럼 이쪽에서 오셔서 치세요
네, 몇 박인가요?	3박 4일이요
음식은 어떻게 주문하나요?	음식은 자리에 가시면 컴퓨터로 주문하실 수 있으세요
카드 결제 가능한가요?	카드 결제 가능해요
편의용품은 다있습니까? 목욕 용품이나	다 있어요
성인 2명하고 아이 2명인데, 토요일 방이 있을까요?	이번 주 토요일은 방이 없어요
네, 어떤 타입의 룸으로 도와드릴까요?	스탠더드룸으로 주세요
3월 중순쯤 가족 4인이 모임을 그쪽에서 하려는데요?	3월 중순, 4인 가족 돼요
배달음식을 시켜도 되나요?	이 책자 안에서만 시키실 수 있습니다
캠핑장 해변에서 가까워요?	조금 거리가 있어요
뒷정리는 해주시나요?	뒷정리는 고객님이 해주셔야 해요
파티룸은 몇 층이에요?	파티룸은 제일 윗층이에요
강아지 1마리도 같이 갈 수 있나요?	가능해요
근처 가까운 식당이 있을까요?	걸어서 20분 정도 가시면 식당이 있어요
금연석이 따로 있나요?	저희 PC방은 전부 금연석입니다
혹시 이용시간 알 수 있을까요?	저희 PC방은 24시간 운영합니다
장기 투숙할 경우에는 얼마인가요?	장기 투숙은 한 달에 100만 원이에요
대실 되나요?	대실 가능하세요
숯불구이 해먹을 수 있는 시설도 되어 있나요?	방앞에 개별 테라스에 바비큐 시설이 되어 있어요
토요일은 얼마에요?	토요일은 6만원이고 일요일은 5만원이에요
대실 가능한가요?	지금은 숙박만 가능한 시간이에요
4명이 들어갈 수 있는 방은 1박에 얼마인가요?	10만 원이에요
프린트는 한 장에 얼마예요?	100원씩이에요
현금결제는 어떻게 합니까?	피씨 화면에서 현금결제 누르시고 저희 직원이 가면 주시면 됩니다
바비큐장은 몇 시까지 이용할 수 있어요?	밤 9시까지 가능해요
재떨이 필요하세요?	알겠습니다
이용료는 얼마인가요?	5만 원입니다
중국집 전화번호 좀 주시겠어요?	여기 있습니다
카라반 위치는 지정인가요?	구역만 정해져있고 오시는 순서대로 배정돼요
비품으로 있는 거는 뭐죠?	비품이 있기는 한데 들고 오시는 게 좋아요
성함 알려주시겠어요?	박보영입니다
큰 방은 하루에 얼마죠?	큰 방은 1박에 10만 원이에요
몇 명이죠?	1박에 5만 원이에요
성인 두 분 디럭스 더블룸 맞으세요?	마운틴 뷰로 예약하셨는데 오션 뷰 방으로 업그레이드 해드릴게요
칼라 하실 건가요?	다 흑백이긴 합니다
가족 구성원이 어떻게 되시나요?	유아는 요금이 따로 추가되지 않아요
체크인과 체크아웃 시간이 어떻게 되나요?	체크인은 8시이며 체크아웃은 11시예요
몇 분이나 오실 건가요?	4명 가족입니다
하루 숙박비가 얼마정도 되나요?	최저가가 5만원이고, 토요일은 더 비싸요
후불로도 사용 가능한가요?	저희는 후불 안되고 선불만 받고 있어요
예약 확인 하려는데, 카드가 없는데 다른 방법은 없나요?	약 시 전송해드린 예약 번호도 가능해요
지금 체크인할 수 있나요?	체크인 가능 시간은 오후 4시부터입니다
수건이나 세면도구는 구비되어있나요?	치약, 샴푸, 바디워시 있어요
1시간 이용 대금 얼마예요?	1천 원입니다
여기서 얼마나 걸리나요?	여기 키랑 휴지 드릴게요
그럼 이따 포켓볼 치는 방법 좀 알려주실 수 있나요?	자리 나면 안내해드리겠습니다
핸드폰 번호 알려주시겠어요?	010 0000 0000입니다
지금 어디세요?	경산에 있거든요
수건이랑 샴푸 같은 거는 있나요?	기본적인 샤워용품은 욕실에 있고 칫솔만 따로 구매하셔야 돼요
라면도 같이 주세요	가져다드리겠습니다
결제는 카드로 되나요?	카드로 결제 가능해요
예약하는 기간에 진행되는 이벤트 같은 게 있나요?	이벤트는 포털사이트에서 저희 호텔 이름 검색하시면 나오는 홈페이지에 프로모션과 패키지가 안내되어 있어요
어디서 오시는데요?	대구에서요
생수는 무료로 이용할 수 있나요?	디럭스 트윈은 삼인 기준이라 객실 하나당 생수가 세 개씩 들어 있어요
여기 1시간에 얼마죠?	500원이요
1시간에 얼마인가요?	한 시간에 1400원입니다
카드 결제도 가능합니다만, 현금 결제 시 10% 할인을 받으실 수 있으신데 어떤걸로 도와드릴까요?	숙박요금 10만 원에 현금 결제 10% 할인받으셔서 9만 원 결제해드릴게요
조용한 침대방으로 부탁합니다	403호로 드릴게요
카드 되죠?	됩니다
음료도 있나요?	탄산음료가 있습니다
청소년들은 혹시 몇 시까지 이용 가능한가요?	청소년들은 밤 10시까지 이용 가능합니다
회원은 얼마인가요	회원은 시간당 1000원입니다
몇 분 주무세요?	한 사람요.
기본 시간이 어떻게 되나요?	대실 기본시간은 2시간이에요
대실 몇 시간 이용 가능해요?	대실 사용시간은 5시간이에요
날짜가 언제 필요하신 거예요?	사월 이십칠일 정도요
근데 열 시간 선불하면 한 시간 주는 이벤트는 끝났나요?	그건 오픈 기념으로 하던 거라 끝났어요
커플석 있나요?	남는 자리 있어요
현금영수증 주시겠어요?	휴대폰 번호 입력해 주세요
여기는 시간당 얼마인가요?	1500원입니다
사월 이십칠일 경에 일박 묵고 싶은데 방이 보통 가족들 쓸 수 있는 방이 있나요?	사월 이십칠일 토요일 예약 가능해요
오월에 입실하시는 거죠?	오월 칠, 팔, 구 일이요
디럭스룸 이용할 건데 얼마인가요?	13만 원이에요
당구장 영업시간이 언제까지 입니까?	11시부터 새벽3시까지에요
거기 가면, 대게 먹을 데는 많나요?	주변에 대게 먹을 식당은 많아요
영수증은 버려주세요	감사합니다
더 큰 방으로 지금 바꿀 수 있나요?	추가 비용 3만 원 합해서 8만 원이에요
라면 주문하려고 하는데요	3500원입니다
성함이 어떻게 되시죠?	약자 확인을 위해 신분증 좀 보여주세요
조용한 곳이죠?	조용해요
혹시 와이파이는 다 설치되어있나요?	와이파이 설치되어 있습니다
바비큐 파티를 위해 그릴을 사용하려는데 이용비가 있나요?	그릴 이용비는 숯 포함하여 2만 원이에요
이용 비용은 선불인가요?	후불입니다
제가 어떻게 하면 될까요?	우선 사장님께 전화드려볼게요
바비큐 가능한가요?	가능해요
내일 조식 이용하려는데 지금 미리 신청해야 하나요?	내일 아침에 하셔도 되지만 지금 신청하시면 할인된 가격으로 이용하실 수 있어요
대실 가능한가요?	지금은 숙박만 가능해요
와이파이도 다 설치되어 있나요?	설치되어 있는데 비밀번호가 걸려 있어요
네 9번으로 1시간 적립해 드릴까요?	1시간 적립이고 천원 여기 있습니다
결제는 카카오페이 되나요?	아직 카카오 페이로는 결제가 안돼요
한 게임 당 얼마인가요?	포켓볼은 2000원, 4구는 2500원입니다
2박에 15만 원, 괜찮으세요?	금방 준비해드릴게요
방 값은 얼마인가요?	하루에 50000원이에요
네 우선 한 시간 이용하겠습니다	원하는 자리가 앉으세요
사장님, 혹시 주차할 데 있어요?	지하 1층하고 2층 다 주차장이에요
콘도 예약하려고 전화드렸는데요?	설악산이요
영업시간이 어떻게 되나요?	11시 부터 마감은 거의 새벽 4시까지 해요
주차는 할 수 있나요?	저희 PC방같은 경우 주위에 병원도 있고 해서 주위에 주차하기 어려우실거에요
디럭스룸은 가격 차이가 많이 납니까?	디럭스룸은 비즈니스룸보다 2만 원 비싸요
3구로 바꿔주세요	금방 가져다드릴게요
회원가입하면 혜택이 있나요?	회원이면 한 시간에 1000원입니다
좀 이따가 올려고 하는데 여기서 시켜먹는건 안되죠?	저희도 메뉴 있는데 정 맘에 안들면 그냥 시켜먹으셔도 돼요
바비큐장은 저녁 몇 시부터 이용할 수 있어요?	바비큐는 열한 시 열두 시 되면 근처에 민가가 있어서 곤란하고 그전 시간에는 크게 상관없어요
음식도 주문하면 다 만들어 주시는 거에요?	주문하면 다 만들어드립니다
호텔 이용 시간은 몇 시부터 몇 시까지인가요?	오후 세 시 체크인하시고, 다음날 열두 시에 체크아웃하시면 돼요
자리 있나요?	물론이죠
2인실로 예약 부탁드려도 되나요?	1박시 요금은 6만 원 되겠습니다
3시간이요	저기 키오스크 이용해주세요
아이폰 충전기 있나요?	충전기는 각 좌석에 여러 종류로 배치되어 있어요
한 시간 요금이 얼마인가요?	3천 원입니다
초크는 몇 개까지 제공해주시나요	기본 2개 드리고 개당 1000원씩 추가요금 있습니다
예약은 몇 일 전쯤 전화드려야 하나요?	정해진 건 없는데 4월은 봄철이라 토요일은 예약이 조금 들어와요
온돌룸이랑 퀸 침대 있는 룸이 있는데 어떤 걸로 하시겠습니까?	온돌룸으로 예약할게요
매점은 어디 있나요?	캠핑카 옆에 보시면 있어요
혹시 예약도 가능합니까?	예약 가능합니다
객실 예약 말씀이시죠?	방 하나 예약하려고요
몇 분입니까?	총 8명이라 가족 룸이 필요한데
1시간에 얼마인가요?	4천 원입니다
다음 주 토요일로 예약하고 싶은데, 방 있나요?	확인해보니 예약 가능하네요
방이 세 가지 타입인 거 아시나요?	세 가지인 거 알아요
대대 한 시간 사용할 수 있나요?	사용하실 수 있습니다
돈가스 판매하나요?	판매하지 않습니다
10분당 얼마씩인가요?	10분당 2000원씩입니다
일반실 특실 남아있는데 어디로 묵으시겠어요?	일반실로 해주세요
이불은 충분하게 있고요?	이불은 추가되니 걱정 안 하셔도 돼요
분당이면 10분씩인가요?	맞아요
방 있어요?	방 있어요
시외버스 타고 오세요?	어떻게 할까, 고민 중이거든요
카카오페이 부분은 잘 모르시나요?	죄송하지만 카카오페이 부분은 제가 잘 몰라요
몇 분이신데요?	5명이요
방 크기하고 금액이 상관이 있나요?	일반 슈페리어 룸은 일곱 평 한 사이즈이고, 침대가 한 개냐 두 개냐만 골라서 예약해주시면 되세요
세면도구 세트 천 원인데 구입하시겠어요?	주세요
바닥에 온돌난방 되나요?	객실 안 온도조절기로 이용하시면 됩니다
하고 싶으신 게 있나요?	사우나나 뭐 헬스나 여러 가지를 하고 싶어요
추가 인원에 대한 추가 비용이 있나요?	기준 인원을 초과한 인원이 있는 경우 추가비가 있어요
혹시 회원가입은 어떻게 해야하나요?	자리에 앉아서 본인인증 하시면 됩니다
이번 주 토요일 예약을 하려는 데 가능할까요?	트윈 베드 룸으로 예약해드릴게요
저기서 쳐도 돼요?	아무 데서나 치셔도 돼요
예약하고 싶은데 결제는 어떻게 하면 되나요?	현장에서 결제하셔도 되고 계좌이체하실 수도 있어요
가족 룸은 가격이 얼마인가요?	가족 룸은 27만4천원이에요
이번 주말 예약 가능할까요?	그렇다면 독채펜션으로 예약이 가능해요
조식은 제공되나요?	조식도 가능하신데 오전 아홉 시부터 열 시까지 토스트하고 커피가 펜션 내에 있는 카페에 마련되어 있어요
7시 예약했는데 확인해주실래요?	안내해 드리겠습니다
오늘 몇 시까지 영업하시나요?	새벽 1시까지 합니다
조식은 되나요?	저희 펜션은 조식이 없어요
아니 30분 전에 주문했는데 라면이 아직도 안 나오는 게 말이 되나요?	현재 저녁시간이라 주문이 많이 몰렸어요
자리 있나요?	여기서 치시면 돼요
컴퓨터 사양은 어느정도 되나요?	그래픽카드 사양이 GTX1080이에요
혹시 음식 주문은 피씨에서 할 수 있나요?	음식 주문은 피씨에서 가능합니다
시트 같은 것도 마찬가지죠?	요청하면 드려요
세면도구는 구비되어 있나요?	샴푸와 보디로션은 기본으로 있고, 드라이기도 있어요
아기 이유식 데울 전자레인지가 필요한데요?	1층 뷔페 직원에게 주시면 주방에서 데워 나오도록 도와드리고 있어요
3월 중순 주말에 2명이 가려는데 요금이 어떻게 되는지 여쭤보려고요?	방은 25만원, 35만원, 36만원이 있어요
몇 시 체크아웃 원하시나요?	한 2시쯤 체크아웃 하고 싶어요
화장실은 어디인가요?	왼쪽으로 직진하시면 오른 편에 있습니다
헤드셋 있나요?	신분증 주시면 반납하실 때 드릴게요
체크인 시간은 몇시예요?	펜션은 3시 입실, 11시 퇴실이에요
제휴 할인 카드는 있나요?	제휴 할인은 없어요. 결제하실 때 무이자 할부 등의 정확한 상담은 프런트 데스크에서 가능하세요
혹시 여기 피씨방 영업시간이 어떻게 되나요?	피씨방은 어디든 24시간입니다
온수풀도 이용 가능한가요?	온수풀은 아침 7시부터 오후 7시까지 이용 가능해요
시설 이용할 수 있는 쿠폰 주시나요?	1층 카페에서 아메리카노 2잔 쿠폰 드려요
근처 슈퍼는 어디에 있나요?	차 타고 5분 나가셔야 합니다
침대방인가요?	온돌방이에요
비상구는 따로 있나요?	문 밖에 나가면 바로 있어요
체크 아웃은 몇 시까지 하면 될까요?	내일 1시까지만 방 비워주시면 돼요
오렌지 라임 방 보시겠어요?	1층이라 침대 1개가 있고 바닥에 주무실 수 있게 이불은 드리거든요
장비는 제 것을 써도 되나요?	대여만 하실 수 있어요
위치가 어떻게 되죠?	창동역 1번 출구 바로 앞에 있습니다
청소년들은 몇 시까지 사용이 가능한가요?	오후 10시까지 사용 가능합니다
계산은 혹시 카드도 가능한가요?	카드도 가능하세요
흡연실은 어디죠?	흡연실은 화장실 옆쪽에 있어요
혹시 후불도 가능하죠?	후불도 가능합니다
세면도구 세트는 얼마에요?	세면도구 세트 천 원이에요
무료 음료 제공은 있나요?	생수 무료로 두 병 제공되고 있어요
와이파이 약하면 공유기 가져가도 괜찮아요?	공유기 있으면 편하게 쓰실 수 있어요
펜션에 자동차 끌고 가면 서울 강동구에서 얼마나 걸릴까요?	한 시간 정도 걸릴 것 같아요
화장실은 어디에 있어요?	밖으로 나가셔서 오른쪽으로 가시면 됩니다
룸 가격은 어떻게 되나요?	시내 전망은 조식 불포함으로 십이만 원이고, 오션뷰는 십육만 원이에요
몇 분이신가요?	7명입니다
예약은 가능하시고 몇 분이 오시나요?	초등학생 두 명하고 성인 두 명, 네 명이 이용하려고요
자리 어디 비었어요?	7번으로 가세요
수건은 당연히 바꿔주시죠?	수건도 추가돼요
바비큐 세트도 같이 예약 가능한가요?	3인 세트 7만 원이에요
2명 두 시간이요	2400원입니다
회원가입을 안해도 이용할 수 있나요?	그러시면 비회원으로 이용하면 됩니다
어떤 거 하실 거예요?	저기 한자리 있네요
조식이 포함된 가격인가요?	저희는 조식은 없어요
1박에 얼마죠?	1박에 5만 원이세요
단체 할인은 혹시 가능한가요?	20분 이상 투숙이셔서 10퍼센트 할인 적용해드리겠습니다
여기 영업시간이 몇 시 까지에요?	11시부터 새벽 6시까지에요
총 2박 할 건데 할인되나요?	연이어 2박 하시는 경우 2만 원 빼드릴게요
결제는 현금이랑 카드 둘 다 가능한가요?	현금만 되세요
할인되는 카드나 제휴 어플이 있으신가요?	제휴 어플 회원이에요
주문한 음식 계산은 어떻게 하나요?	선불로 충전한 요금으로 결제하시거나 따로 결제 가능합니다
오션뷰 방은 얼마예요?	10만 원이에요
내일 아침 7시에 모닝콜 해주실 수 있나요?	아침 7시에 모닝콜 해드릴게요
몇 분이신가요?	죄송하지만 반려동물은 숙박이 불가능해요
지금 예약 할 수 있나요?	총원 6명 일요일부터 2박 패밀리룸 예약되었어요
주차할 수 있는 곳도 있나요?	PC방 주변 보시면 주차구역 있습니다
요금은 10분에 얼마인가요?	요금은 1300원이었는데 2월 1일부터 불경기라 800원으로 내렸어요
배틀그라운드 이벤트 지금도 하고 있어요?	배틀그라운드 이벤트 진행중입니다
엑스트라 베드 추가는 얼마죠?	2만 원이에요
토요일, 일요일은 요금이 같나요?	토요일과 일요일 요금은 동일해요
하루 숙박요금은 어떻게 되나요?	1박에 5만 원이에요
혹시 프린트는 불가능한가요?	지금 프린트기가 고장 나서요
